time,num1,num2,result,answer,date,correct,operation
2.2824828999998767,18,3,21,21,Apr-11-2020,1,<ufunc 'add'>
1.4246428999999807,12,12,24,24,Apr-11-2020,1,<ufunc 'add'>
1.46894199999997,9,9,18,18,Apr-11-2020,1,<ufunc 'add'>
1.4299229999999168,16,1,17,17,Apr-11-2020,1,<ufunc 'add'>
1.3873340000000098,18,1,19,19,Apr-11-2020,1,<ufunc 'add'>
1.5391901000000416,4,15,19,19,Apr-11-2020,1,<ufunc 'add'>
1.6739845999998124,13,4,17,17,Apr-11-2020,1,<ufunc 'add'>
1.2597714999999423,0,16,16,16,Apr-11-2020,1,<ufunc 'add'>
2.17835910000008,17,7,24,24,Apr-11-2020,1,<ufunc 'add'>
5.899934300000041,19,17,36,36,Apr-11-2020,1,<ufunc 'add'>
1.8187986999998884,2,17,19,19,Apr-11-2020,1,<ufunc 'add'>
3.719568399999844,13,15,28,28,Apr-11-2020,1,<ufunc 'add'>
1.5111696000001302,0,10,10,10,Apr-11-2020,1,<ufunc 'add'>
1.6694637999999031,17,7,24,24,Apr-11-2020,1,<ufunc 'add'>
2.3021052000001423,12,5,17,18,Apr-11-2020,0,<ufunc 'add'>
6.8980488999998215,8,12,20,20,Apr-11-2020,1,<ufunc 'add'>
1.7117462999999589,1,19,20,20,Apr-11-2020,1,<ufunc 'add'>
3.5065916999999445,13,14,27,27,Apr-11-2020,1,<ufunc 'add'>
3.1604314999999588,17,13,30,30,Apr-11-2020,1,<ufunc 'add'>
1.467117000000144,0,13,13,13,Apr-11-2020,1,<ufunc 'add'>
1.440722600000072,13,13,26,26,Apr-11-2020,1,<ufunc 'add'>
5.80900399999996,7,16,23,23,Apr-11-2020,1,<ufunc 'add'>
2.8287823999999087,16,12,28,28,Apr-11-2020,1,<ufunc 'add'>
2.3677058000000666,19,11,30,30,Apr-11-2020,1,<ufunc 'add'>
1.972465800000009,1,19,20,20,Apr-11-2020,1,<ufunc 'add'>
1.6954972999999427,17,1,18,18,Apr-11-2020,1,<ufunc 'add'>
4.3012456000001285,4,13,17,17,Apr-11-2020,1,<ufunc 'add'>
1.833275400000048,6,12,18,18,Apr-11-2020,1,<ufunc 'add'>
2.635348400000112,8,9,17,17,Apr-11-2020,1,<ufunc 'add'>
2.936943100000008,3,19,22,22,Apr-11-2020,1,<ufunc 'add'>
2.7377796000000667,19,5,24,24,Apr-11-2020,1,<ufunc 'add'>
2.6538106999998945,11,3,14,14,Apr-11-2020,1,<ufunc 'add'>
1.4309912999999597,1,15,16,16,Apr-11-2020,1,<ufunc 'add'>
1.1508248000000094,0,6,6,6,Apr-11-2020,1,<ufunc 'add'>
1.2881301000002168,1,16,17,17,Apr-11-2020,1,<ufunc 'add'>
1.2457091999999648,1,16,17,17,Apr-11-2020,1,<ufunc 'add'>
2.5292384000001675,5,8,13,13,Apr-11-2020,1,<ufunc 'add'>
8.234594699999889,19,13,32,32,Apr-11-2020,1,<ufunc 'add'>
3.3730465999999524,16,5,21,21,Apr-11-2020,1,<ufunc 'add'>
3.1134832000000188,10,18,28,28,Apr-11-2020,1,<ufunc 'add'>
1.3094561000000342,1,4,5,5,Apr-11-2020,1,<ufunc 'add'>
2.3362425999998777,6,18,24,24,Apr-11-2020,1,<ufunc 'add'>
1.89296719999993,3,14,17,17,Apr-11-2020,1,<ufunc 'add'>
2.700914399999874,10,17,27,27,Apr-11-2020,1,<ufunc 'add'>
1.5425422000000708,17,1,18,18,Apr-11-2020,1,<ufunc 'add'>
1.5194830000000366,10,6,16,16,Apr-11-2020,1,<ufunc 'add'>
1.7279344999999466,5,2,7,7,Apr-11-2020,1,<ufunc 'add'>
3.25561689999995,16,7,23,23,Apr-11-2020,1,<ufunc 'add'>
1.5078282000001764,13,0,13,13,Apr-11-2020,1,<ufunc 'add'>
1.7512378999999785,14,15,29,29,Apr-11-2020,1,<ufunc 'add'>
2.4356860999998844,9,7,16,16,Apr-11-2020,1,<ufunc 'add'>
8.235108899999886,17,18,35,35,Apr-11-2020,1,<ufunc 'add'>
1.5172459000000345,6,4,10,10,Apr-11-2020,1,<ufunc 'add'>
0.9845106000000214,2,0,2,2,Apr-11-2020,1,<ufunc 'add'>
1.8630410000000663,3,12,15,15,Apr-11-2020,1,<ufunc 'add'>
2.6751844000000347,18,4,22,22,Apr-11-2020,1,<ufunc 'add'>
1.7478971000000456,6,15,21,21,Apr-11-2020,1,<ufunc 'add'>
2.0001829000000266,3,17,20,20,Apr-11-2020,1,<ufunc 'add'>
1.244776899999806,13,0,13,13,Apr-11-2020,1,<ufunc 'add'>
1.5567714999999682,7,13,20,20,Apr-11-2020,1,<ufunc 'add'>
1.8447138999999881,2,16,18,18,Apr-11-2020,1,<ufunc 'add'>
2.072718699999996,3,19,22,22,Apr-11-2020,1,<ufunc 'add'>
1.239140599999928,4,10,14,14,Apr-11-2020,1,<ufunc 'add'>
1.756328200000098,14,2,16,16,Apr-11-2020,1,<ufunc 'add'>
1.072868399999834,0,9,9,9,Apr-11-2020,1,<ufunc 'add'>
2.4536378000000236,16,12,28,28,Apr-11-2020,1,<ufunc 'add'>
1.46170630000006,15,15,30,30,Apr-11-2020,1,<ufunc 'add'>
2.33328430000006,11,10,21,21,Apr-11-2020,1,<ufunc 'add'>
1.2007042000000183,14,1,15,15,Apr-11-2020,1,<ufunc 'add'>
1.1696075999998357,1,14,15,15,Apr-11-2020,1,<ufunc 'add'>
1.248689000000013,3,4,7,7,Apr-11-2020,1,<ufunc 'add'>
5.269588499999827,12,19,31,31,Apr-11-2020,1,<ufunc 'add'>
1.6111137000000326,6,8,14,14,Apr-11-2020,1,<ufunc 'add'>
2.001113400000122,1,11,12,12,Apr-11-2020,1,<ufunc 'add'>
2.6261312999999973,4,11,15,15,Apr-11-2020,1,<ufunc 'add'>
3.114540199999965,15,8,23,23,Apr-11-2020,1,<ufunc 'add'>
4.021951700000045,16,16,32,32,Apr-11-2020,1,<ufunc 'add'>
2.112638699999934,17,13,30,30,Apr-11-2020,1,<ufunc 'add'>
3.732267099999945,10,17,27,27,Apr-11-2020,1,<ufunc 'add'>
1.6983046000000286,17,3,20,20,Apr-11-2020,1,<ufunc 'add'>
1.6079669999999169,15,4,19,19,Apr-11-2020,1,<ufunc 'add'>
1.3325423999999657,15,0,15,15,Apr-11-2020,1,<ufunc 'add'>
4.5959559999998865,17,14,31,31,Apr-11-2020,1,<ufunc 'add'>
1.7428615000001173,1,14,15,15,Apr-11-2020,1,<ufunc 'add'>
1.8618168999998943,19,7,26,26,Apr-11-2020,1,<ufunc 'add'>
2.450819600000159,11,15,26,26,Apr-11-2020,1,<ufunc 'add'>
1.870536599999923,5,10,15,15,Apr-11-2020,1,<ufunc 'add'>
1.4400464999998803,2,15,17,17,Apr-11-2020,1,<ufunc 'add'>
2.4869956,4,7,11,11,Apr-11-2020,1,<ufunc 'add'>
1.9882718999999724,14,3,17,17,Apr-11-2020,1,<ufunc 'add'>
2.3714263000001665,7,11,18,18,Apr-11-2020,1,<ufunc 'add'>
2.224717900000087,13,9,22,22,Apr-11-2020,1,<ufunc 'add'>
1.2778178999999454,5,3,8,8,Apr-11-2020,1,<ufunc 'add'>
1.4115908000001127,1,19,20,20,Apr-11-2020,1,<ufunc 'add'>
1.8852937999999997,7,4,11,11,Apr-13-2020,1,<ufunc 'add'>
4.464313599999969,18,7,25,25,Apr-13-2020,1,<ufunc 'add'>
2.0236869999998817,11,4,15,15,Apr-13-2020,1,<ufunc 'add'>
2.575174500000003,18,7,25,25,Apr-13-2020,1,<ufunc 'add'>
2.3115222999999787,14,5,19,19,Apr-13-2020,1,<ufunc 'add'>
1.7764760000000024,4,18,22,22,Apr-13-2020,1,<ufunc 'add'>
4.670587699999942,18,19,37,37,Apr-13-2020,1,<ufunc 'add'>
2.673004600000013,11,14,25,25,Apr-13-2020,1,<ufunc 'add'>
1.5911140000000614,2,16,18,18,Apr-13-2020,1,<ufunc 'add'>
2.3191796999999497,1,6,7,7,Apr-13-2020,1,<ufunc 'add'>
1.640741799999887,16,16,32,32,Apr-13-2020,1,<ufunc 'add'>
1.295087599999988,1,9,10,10,Apr-13-2020,1,<ufunc 'add'>
2.8803505999999284,19,16,35,35,Apr-13-2020,1,<ufunc 'add'>
5.647499299999937,13,19,32,32,Apr-13-2020,1,<ufunc 'add'>
1.7837176000000454,2,15,17,17,Apr-13-2020,1,<ufunc 'add'>
2.3527139999998776,19,3,22,22,Apr-13-2020,1,<ufunc 'add'>
2.9743782999998984,16,7,23,23,Apr-13-2020,1,<ufunc 'add'>
2.2557226999999784,9,15,24,24,Apr-13-2020,1,<ufunc 'add'>
4.07280720000017,16,17,33,33,Apr-13-2020,1,<ufunc 'add'>
4.254814500000066,9,8,17,17,Apr-13-2020,1,<ufunc 'add'>
2.4082765999999083,17,13,30,30,Apr-13-2020,1,<ufunc 'add'>
1.407837499999914,8,4,12,12,Apr-13-2020,1,<ufunc 'add'>
1.5594882999998845,16,8,24,24,Apr-13-2020,1,<ufunc 'add'>
1.3993989999999032,8,10,18,18,Apr-13-2020,1,<ufunc 'add'>
1.3518268000000262,11,11,22,22,Apr-13-2020,1,<ufunc 'add'>
1.0790761999999177,1,5,6,6,Apr-13-2020,1,<ufunc 'add'>
2.688315899999907,5,16,21,21,Apr-13-2020,1,<ufunc 'add'>
1.247619499999928,2,0,2,2,Apr-13-2020,1,<ufunc 'add'>
3.9996704000000136,14,9,23,23,Apr-13-2020,1,<ufunc 'add'>
1.4159998999998606,12,0,12,12,Apr-13-2020,1,<ufunc 'add'>
2.5276117999999315,9,17,26,26,Apr-13-2020,1,<ufunc 'add'>
4.415894200000139,4,17,21,21,Apr-13-2020,1,<ufunc 'add'>
1.880025600000181,15,9,24,24,Apr-13-2020,1,<ufunc 'add'>
1.86419520000004,4,16,20,20,Apr-13-2020,1,<ufunc 'add'>
1.5353121000000556,15,5,20,20,Apr-13-2020,1,<ufunc 'add'>
1.4079216999998607,5,2,7,7,Apr-13-2020,1,<ufunc 'add'>
1.2312414999998964,5,1,6,6,Apr-13-2020,1,<ufunc 'add'>
1.9458789000000247,11,9,20,20,Apr-13-2020,1,<ufunc 'add'>
2.1097611000000143,5,16,21,21,Apr-13-2020,1,<ufunc 'add'>
1.6243008000001282,15,3,18,18,Apr-13-2020,1,<ufunc 'add'>
1.9598515000000132,17,4,21,21,Apr-13-2020,1,<ufunc 'add'>
2.9367072000000007,2,11,13,13,Apr-13-2020,1,<ufunc 'add'>
1.3188556999998582,5,5,10,10,Apr-13-2020,1,<ufunc 'add'>
2.6801688999998987,14,9,23,23,Apr-13-2020,1,<ufunc 'add'>
2.5670577000000776,17,11,28,28,Apr-13-2020,1,<ufunc 'add'>
5.1272348999998485,12,15,27,27,Apr-13-2020,1,<ufunc 'add'>
1.6082034999999453,13,7,20,20,Apr-13-2020,1,<ufunc 'add'>
1.0080410000000484,0,5,5,5,Apr-13-2020,1,<ufunc 'add'>
1.6553989000001366,6,8,14,14,Apr-13-2020,1,<ufunc 'add'>
2.2954595999999583,9,15,24,24,Apr-13-2020,1,<ufunc 'add'>
2.3598558999999573,8,13,21,21,Apr-13-2020,1,<ufunc 'add'>
2.2956973000000294,18,10,28,28,Apr-13-2020,1,<ufunc 'add'>
1.4871349999998529,0,4,4,4,Apr-13-2020,1,<ufunc 'add'>
4.9286722000001655,11,12,23,23,Apr-13-2020,1,<ufunc 'add'>
1.838710800000172,10,11,21,21,Apr-13-2020,1,<ufunc 'add'>
3.94504169999982,18,11,29,29,Apr-13-2020,1,<ufunc 'add'>
5.582060599999976,16,6,22,22,Apr-13-2020,1,<ufunc 'add'>
1.0724134000001868,1,3,4,4,Apr-13-2020,1,<ufunc 'add'>
1.0390012000000295,1,4,5,5,Apr-13-2020,1,<ufunc 'add'>
2.408378099999936,17,6,23,23,Apr-13-2020,1,<ufunc 'add'>
3.5046857999998338,11,19,30,30,Apr-13-2020,1,<ufunc 'add'>
2.606960900000104,19,6,25,25,Apr-13-2020,1,<ufunc 'add'>
1.9199894000000768,16,8,24,24,Apr-13-2020,1,<ufunc 'add'>
1.72647209999991,4,16,20,20,Apr-13-2020,1,<ufunc 'add'>
5.792199299999992,16,17,33,33,Apr-13-2020,1,<ufunc 'add'>
1.248022100000071,4,0,4,4,Apr-13-2020,1,<ufunc 'add'>
1.4793595999999525,2,6,8,8,Apr-13-2020,1,<ufunc 'add'>
4.3524946,16,10,26,26,Apr-13-2020,1,<ufunc 'add'>
4.991405299999997,19,18,37,37,Apr-13-2020,1,<ufunc 'add'>
6.159686999999849,13,14,27,27,Apr-13-2020,1,<ufunc 'add'>
1.7834163999998507,10,1,11,11,Apr-13-2020,1,<ufunc 'add'>
2.0482463999999254,5,8,13,13,Apr-13-2020,1,<ufunc 'add'>
1.9835782999998628,2,9,11,11,Apr-13-2020,1,<ufunc 'add'>
2.0313570999999233,11,8,19,19,Apr-13-2020,1,<ufunc 'add'>
1.5728485999999862,1,14,15,15,Apr-15-2020,1,<ufunc 'add'>
2.4717313000000445,11,12,23,23,Apr-15-2020,1,<ufunc 'add'>
1.191235699999993,16,0,16,16,Apr-15-2020,1,<ufunc 'add'>
1.6484543000000258,6,5,11,11,Apr-15-2020,1,<ufunc 'add'>
1.599289199999987,9,4,13,13,Apr-15-2020,1,<ufunc 'add'>
1.3118260000000532,2,18,20,20,Apr-15-2020,1,<ufunc 'add'>
0.9031123999999976,0,0,0,0,Apr-15-2020,1,<ufunc 'add'>
1.4486549999999738,12,6,18,18,Apr-15-2020,1,<ufunc 'add'>
2.5838698999999683,11,7,18,18,Apr-15-2020,1,<ufunc 'add'>
2.2479646999999545,11,7,18,18,Apr-15-2020,1,<ufunc 'add'>
1.3029895999999894,19,1,20,20,Apr-15-2020,1,<ufunc 'add'>
4.599915399999986,17,4,21,21,Apr-15-2020,1,<ufunc 'add'>
1.9837264999999888,5,19,24,24,Apr-15-2020,1,<ufunc 'add'>
2.7431075000000082,15,18,33,33,Apr-15-2020,1,<ufunc 'add'>
1.9837191000000305,10,13,23,23,Apr-15-2020,1,<ufunc 'add'>
1.1761745999999675,1,19,20,20,Apr-15-2020,1,<ufunc 'add'>
1.8726333000000184,12,11,23,23,Apr-15-2020,1,<ufunc 'add'>
0.9919012000000292,1,2,3,3,Apr-15-2020,1,<ufunc 'add'>
1.5912963999999759,16,16,32,32,Apr-15-2020,1,<ufunc 'add'>
1.5916086999999948,3,16,19,19,Apr-15-2020,1,<ufunc 'add'>
2.0228649000000023,9,7,16,16,Apr-15-2020,1,<ufunc 'add'>
4.3840210000000175,9,13,22,22,Apr-15-2020,1,<ufunc 'add'>
4.232072899999992,13,10,23,23,Apr-15-2020,1,<ufunc 'add'>
2.007946199999992,7,7,14,14,Apr-15-2020,1,<ufunc 'add'>
1.6156249000000005,11,1,12,12,Apr-15-2020,1,<ufunc 'add'>
2.111463500000013,15,11,26,26,Apr-15-2020,1,<ufunc 'add'>
3.0958703000000014,3,19,22,22,Apr-15-2020,1,<ufunc 'add'>
2.976415600000053,16,7,23,23,Apr-15-2020,1,<ufunc 'add'>
1.6555119999999874,17,2,19,19,Apr-15-2020,1,<ufunc 'add'>
1.3604803000000059,5,10,15,15,Apr-15-2020,1,<ufunc 'add'>
2.1992111000000136,4,14,18,18,Apr-15-2020,1,<ufunc 'add'>
2.9755091000000107,5,12,17,17,Apr-15-2020,1,<ufunc 'add'>
1.8879574000000048,11,4,15,15,Apr-15-2020,1,<ufunc 'add'>
2.11969670000002,15,13,28,28,Apr-15-2020,1,<ufunc 'add'>
1.1911531000000082,7,7,14,14,Apr-15-2020,1,<ufunc 'add'>
1.952262800000028,18,12,30,30,Apr-15-2020,1,<ufunc 'add'>
3.5116509000000065,12,19,31,31,Apr-15-2020,1,<ufunc 'add'>
1.2566534999999703,5,0,5,5,Apr-15-2020,1,<ufunc 'add'>
4.526921099999981,9,17,26,26,Apr-15-2020,1,<ufunc 'add'>
2.9757114999999885,11,8,19,19,Apr-15-2020,1,<ufunc 'add'>
1.5924991999999634,17,0,17,17,Apr-15-2020,1,<ufunc 'add'>
2.591102899999953,9,13,22,22,Apr-15-2020,1,<ufunc 'add'>
4.446904600000039,15,18,33,33,Apr-15-2020,1,<ufunc 'add'>
1.5447490999999898,4,14,18,18,Apr-15-2020,1,<ufunc 'add'>
1.6951081999999928,16,8,24,24,Apr-15-2020,1,<ufunc 'add'>
2.736521099999948,8,5,13,13,Apr-15-2020,1,<ufunc 'add'>
2.1991752000000133,7,8,15,15,Apr-15-2020,1,<ufunc 'add'>
1.3685894000000192,7,1,8,8,Apr-15-2020,1,<ufunc 'add'>
2.006910600000026,13,9,22,22,Apr-15-2020,1,<ufunc 'add'>
1.855303200000037,6,15,21,21,Apr-15-2020,1,<ufunc 'add'>
3.0395692999999824,18,7,25,15,Apr-15-2020,0,<ufunc 'add'>
3.927722399999993,1,13,14,14,Apr-15-2020,1,<ufunc 'add'>
3.727814200000012,19,14,33,33,Apr-15-2020,1,<ufunc 'add'>
2.0877131000000304,10,12,22,22,Apr-15-2020,1,<ufunc 'add'>
3.7524654999999716,5,18,23,23,Apr-15-2020,1,<ufunc 'add'>
1.8148206999999843,10,16,26,26,Apr-15-2020,1,<ufunc 'add'>
2.4560266000000297,16,17,33,25,Apr-15-2020,0,<ufunc 'add'>
10.695832100000018,3,2,5,5,Apr-15-2020,1,<ufunc 'add'>
1.0000143999999975,2,3,5,5,Apr-15-2020,1,<ufunc 'add'>
1.6396282000000042,9,2,11,11,Apr-15-2020,1,<ufunc 'add'>
1.1281862000000158,15,1,16,16,Apr-15-2020,1,<ufunc 'add'>
1.8395668,16,0,16,16,Apr-15-2020,1,<ufunc 'add'>
1.5122802999999865,8,8,16,16,Apr-15-2020,1,<ufunc 'add'>
2.015845200000001,10,19,29,29,Apr-15-2020,1,<ufunc 'add'>
1.6156384999999889,6,4,10,10,Apr-15-2020,1,<ufunc 'add'>
1.415096999999946,19,1,20,20,Apr-15-2020,1,<ufunc 'add'>
2.520229799999981,18,9,27,27,Apr-15-2020,1,<ufunc 'add'>
1.1277522999999974,5,4,9,9,Apr-15-2020,1,<ufunc 'add'>
3.4631074999999782,7,15,22,22,Apr-15-2020,1,<ufunc 'add'>
1.6485050999999658,11,11,22,22,Apr-15-2020,1,<ufunc 'add'>
1.4723336999999788,13,3,16,16,Apr-15-2020,1,<ufunc 'add'>
1.7881331000007776,3,18,21,21,Apr-16-2020,1,<ufunc 'add'>
1.0642813000004026,5,4,9,9,Apr-16-2020,1,<ufunc 'add'>
3.2318993999997474,9,8,17,17,Apr-16-2020,1,<ufunc 'add'>
2.375870300000315,8,7,15,15,Apr-16-2020,1,<ufunc 'add'>
1.3436169999995402,19,1,20,20,Apr-16-2020,1,<ufunc 'add'>
2.9841777999999977,17,14,31,31,Apr-16-2020,1,<ufunc 'add'>
2.622700099999747,19,5,24,24,Apr-16-2020,1,<ufunc 'add'>
1.1608175999999728,0,6,6,6,Apr-16-2020,1,<ufunc 'add'>
3.055315999999948,16,7,23,23,Apr-16-2020,1,<ufunc 'add'>
1.6960589999998774,10,13,23,23,Apr-16-2020,1,<ufunc 'add'>
2.040149399999791,9,13,22,22,Apr-16-2020,1,<ufunc 'add'>
2.391771799999333,9,12,21,21,Apr-16-2020,1,<ufunc 'add'>
3.3835003999993205,14,9,23,23,Apr-16-2020,1,<ufunc 'add'>
1.7360493999995017,7,3,10,10,Apr-16-2020,1,<ufunc 'add'>
1.2239855999996507,10,5,15,15,Apr-16-2020,1,<ufunc 'add'>
1.2235912000005555,11,1,12,12,Apr-16-2020,1,<ufunc 'add'>
1.576228699999774,3,14,17,17,Apr-16-2020,1,<ufunc 'add'>
3.3512206999994305,11,15,26,26,Apr-16-2020,1,<ufunc 'add'>
3.503492000000733,12,15,27,27,Apr-16-2020,1,<ufunc 'add'>
1.911726000000272,7,17,24,24,Apr-16-2020,1,<ufunc 'add'>
1.1677796999993006,1,6,7,7,Apr-16-2020,1,<ufunc 'add'>
1.3680779999995138,2,15,17,17,Apr-16-2020,1,<ufunc 'add'>
1.4639545999998518,0,17,17,17,Apr-16-2020,1,<ufunc 'add'>
1.1759253999998691,9,9,18,18,Apr-16-2020,1,<ufunc 'add'>
1.423920199999884,5,15,20,20,Apr-16-2020,1,<ufunc 'add'>
1.2713170000006355,4,4,8,8,Apr-16-2020,1,<ufunc 'add'>
1.0875160000005053,0,15,15,15,Apr-16-2020,1,<ufunc 'add'>
1.5442948999998407,4,18,22,22,Apr-16-2020,1,<ufunc 'add'>
4.063782100000026,18,19,37,37,Apr-16-2020,1,<ufunc 'add'>
2.423768900000141,13,9,22,22,Apr-16-2020,1,<ufunc 'add'>
1.2721188000004986,9,2,11,11,Apr-16-2020,1,<ufunc 'add'>
1.143387399999483,1,14,15,15,Apr-16-2020,1,<ufunc 'add'>
1.519967500000348,2,13,15,15,Apr-16-2020,1,<ufunc 'add'>
1.4232007000000522,9,2,11,11,Apr-16-2020,1,<ufunc 'add'>
2.1598267999997915,7,5,12,12,Apr-16-2020,1,<ufunc 'add'>
1.9838727000005747,7,6,13,13,Apr-16-2020,1,<ufunc 'add'>
1.5118290999998862,1,13,14,14,Apr-16-2020,1,<ufunc 'add'>
1.2799733000001652,4,8,12,12,Apr-16-2020,1,<ufunc 'add'>
1.039549299999635,4,0,4,4,Apr-16-2020,1,<ufunc 'add'>
2.36022899999989,18,13,31,31,Apr-16-2020,1,<ufunc 'add'>
4.030962499999987,7,14,21,21,Apr-16-2020,1,<ufunc 'add'>
2.424128099999507,17,14,31,31,Apr-16-2020,1,<ufunc 'add'>
1.3442776000001686,7,7,14,14,Apr-16-2020,1,<ufunc 'add'>
3.9748927000000553,14,18,32,32,Apr-16-2020,1,<ufunc 'add'>
1.560048999999708,12,12,24,24,Apr-16-2020,1,<ufunc 'add'>
1.0643847999999707,5,4,9,9,Apr-16-2020,1,<ufunc 'add'>
2.231350299999576,5,17,22,22,Apr-16-2020,1,<ufunc 'add'>
2.7916649999997394,11,15,26,26,Apr-16-2020,1,<ufunc 'add'>
1.2401755000000776,8,1,9,9,Apr-16-2020,1,<ufunc 'add'>
1.1760333000001992,1,5,6,6,Apr-16-2020,1,<ufunc 'add'>
1.0963768999999957,0,11,11,11,Apr-16-2020,1,<ufunc 'add'>
1.1753417999998421,7,0,7,7,Apr-16-2020,1,<ufunc 'add'>
1.142749300000105,12,0,12,12,Apr-16-2020,1,<ufunc 'add'>
2.4081898000004003,14,6,20,20,Apr-16-2020,1,<ufunc 'add'>
4.431615800000144,16,18,34,34,Apr-16-2020,1,<ufunc 'add'>
1.3124237000001813,0,11,11,11,Apr-16-2020,1,<ufunc 'add'>
2.455074800000148,1,3,4,4,Apr-16-2020,1,<ufunc 'add'>
0.9283026999992215,3,0,3,3,Apr-16-2020,1,<ufunc 'add'>
1.1278769000000466,0,12,12,12,Apr-16-2020,1,<ufunc 'add'>
1.5443566000003557,0,0,0,0,Apr-16-2020,1,<ufunc 'add'>
2.535143600000083,12,11,23,21,Apr-16-2020,0,<ufunc 'add'>
4.5917904000007175,11,9,20,20,Apr-16-2020,1,<ufunc 'add'>
1.199623700000302,4,4,8,8,Apr-16-2020,1,<ufunc 'add'>
1.2236384000007092,12,12,24,24,Apr-16-2020,1,<ufunc 'add'>
2.504079099999217,13,11,24,24,Apr-16-2020,1,<ufunc 'add'>
1.6557054999993852,11,10,21,21,Apr-16-2020,1,<ufunc 'add'>
1.9916743000003407,9,16,25,25,Apr-16-2020,1,<ufunc 'add'>
3.2642266000002564,16,18,34,34,Apr-16-2020,1,<ufunc 'add'>
3.2401632000000973,13,16,29,29,Apr-16-2020,1,<ufunc 'add'>
3.5432708000007547,6,16,22,22,Apr-16-2020,1,<ufunc 'add'>
2.4960737999999765,5,19,24,24,Apr-16-2020,1,<ufunc 'add'>
0.9520205999997416,0,6,6,6,Apr-16-2020,1,<ufunc 'add'>
2.0716173999999232,7,2,9,9,Apr-16-2020,1,<ufunc 'add'>
2.2074345999999423,9,7,16,16,Apr-16-2020,1,<ufunc 'add'>
1.0639608999999837,6,3,9,9,Apr-16-2020,1,<ufunc 'add'>
1.7034800999999788,8,16,24,24,Apr-16-2020,1,<ufunc 'add'>
0.7679241999994701,2,0,2,2,Apr-16-2020,1,<ufunc 'add'>
3.0720814000005703,19,15,34,34,Apr-16-2020,1,<ufunc 'add'>
4.9676274000003104,8,9,17,17,Apr-16-2020,1,<ufunc 'add'>
3.1917954999998983,14,19,33,33,Apr-16-2020,1,<ufunc 'add'>
2.616158699999687,13,18,31,31,Apr-16-2020,1,<ufunc 'add'>
1.5755190999998376,13,3,16,16,Apr-16-2020,1,<ufunc 'add'>
1.2880991000001814,1,13,14,14,Apr-16-2020,1,<ufunc 'add'>
0.8797617999998693,3,0,3,3,Apr-16-2020,1,<ufunc 'add'>
1.1350587000006271,7,2,9,9,Apr-16-2020,1,<ufunc 'add'>
1.3523144000000684,12,10,22,22,Apr-16-2020,1,<ufunc 'add'>
0.98436109999966,1,2,3,3,Apr-16-2020,1,<ufunc 'add'>
1.199065800000426,0,11,11,11,Apr-16-2020,1,<ufunc 'add'>
1.0880562000002099,6,4,10,10,Apr-16-2020,1,<ufunc 'add'>
1.3839323000001968,2,11,13,13,Apr-16-2020,1,<ufunc 'add'>
5.551526100000046,17,18,35,35,Apr-16-2020,1,<ufunc 'add'>
1.4724714000003587,15,15,30,30,Apr-16-2020,1,<ufunc 'add'>
1.1028886000003697,19,0,19,19,Apr-16-2020,1,<ufunc 'add'>
1.712147599999298,17,15,32,32,Apr-16-2020,1,<ufunc 'add'>
1.5041873000000123,3,16,19,19,Apr-16-2020,1,<ufunc 'add'>
1.5120092000006482,3,15,18,18,Apr-16-2020,1,<ufunc 'add'>
0.9987500999995972,0,12,12,12,Apr-16-2020,1,<ufunc 'add'>
2.3129951999999316,15,8,23,23,Apr-16-2020,1,<ufunc 'add'>
1.1274511000001441,2,6,8,8,Apr-16-2020,1,<ufunc 'add'>
1.0479862000001958,11,0,11,11,Apr-16-2020,1,<ufunc 'add'>
2.0791560999996364,15,14,29,29,Apr-16-2020,1,<ufunc 'add'>
