time,num1,num2,result,answer,date,correct
5.185412000000042,23,26,49,49,Apr-11-2020,1
9.0179713,38,45,83,83,Apr-11-2020,1
3.8427679000000126,34,16,50,50,Apr-11-2020,1
3.2143022999999857,49,11,60,60,Apr-11-2020,1
3.8569170999999187,41,25,66,66,Apr-11-2020,1
3.900953800000025,32,37,69,69,Apr-11-2020,1
5.452364299999999,16,29,45,45,Apr-11-2020,1
3.523901099999989,4,48,52,52,Apr-11-2020,1
5.023548699999992,46,21,67,67,Apr-11-2020,1
5.672446899999954,24,48,72,72,Apr-11-2020,1
7.766603100000111,40,19,59,59,Apr-11-2020,1
5.320598500000074,32,46,78,78,Apr-11-2020,1
1.7189144999999826,4,3,7,7,Apr-11-2020,1
2.072268000000008,4,40,44,44,Apr-11-2020,1
4.010642099999927,33,32,65,65,Apr-11-2020,1
2.860954300000003,6,40,46,46,Apr-11-2020,1
5.871139500000027,26,43,69,69,Apr-11-2020,1
2.5141980999999305,8,15,23,23,Apr-11-2020,1
1.8217504000000417,2,9,11,11,Apr-11-2020,1
6.474619500000017,46,39,85,85,Apr-11-2020,1
3.9514847000000373,28,44,72,72,Apr-11-2020,1
3.8283387000000175,16,15,31,39,Apr-11-2020,0
12.845158900000001,42,20,62,62,Apr-11-2020,1
9.194811200000004,45,22,67,67,Apr-11-2020,1
2.0320196000000124,31,1,32,32,Apr-11-2020,1
5.91763560000004,33,26,59,59,Apr-11-2020,1
5.35975499999995,39,14,53,53,Apr-11-2020,1
3.524637900000016,33,13,46,46,Apr-11-2020,1
10.072945599999912,16,17,33,33,Apr-11-2020,1
2.700559799999951,41,4,45,45,Apr-11-2020,1
1.8608912000000828,1,38,39,39,Apr-11-2020,1
2.5595597000000225,18,5,23,23,Apr-11-2020,1
4.217074199999956,31,46,77,77,Apr-11-2020,1
6.116581099999962,35,49,84,84,Apr-11-2020,1
1.284552700000063,0,1,1,1,Apr-11-2020,1
2.004329299999995,21,2,23,23,Apr-11-2020,1
7.667345699999942,14,49,63,63,Apr-11-2020,1
4.567681500000049,31,11,42,42,Apr-11-2020,1
6.769831299999964,26,38,64,64,Apr-11-2020,1
1.7107320999999729,1,19,20,20,Apr-11-2020,1
1.9390489999999545,5,40,45,45,Apr-11-2020,1
7.374655699999948,13,48,61,61,Apr-11-2020,1
2.8445087000000058,30,41,71,71,Apr-11-2020,1
3.186010499999952,31,19,50,50,Apr-11-2020,1
2.3303756999999905,1,48,49,49,Apr-11-2020,1
4.871107199999983,33,23,56,56,Apr-11-2020,1
3.342284100000029,6,13,19,19,Apr-11-2020,1
2.1988251999999875,33,10,43,43,Apr-11-2020,1
4.350320399999987,23,17,40,40,Apr-11-2020,1
2.602731100000028,40,11,51,51,Apr-11-2020,1
2.472166299999799,16,11,27,27,Apr-13-2020,1
2.159728899999891,27,6,33,33,Apr-13-2020,1
2.1919414999999844,10,26,36,36,Apr-13-2020,1
8.25626269999998,38,45,83,83,Apr-13-2020,1
2.25565070000016,20,40,60,60,Apr-13-2020,1
1.8551857999998447,3,36,39,39,Apr-13-2020,1
1.056123800000023,1,3,4,4,Apr-13-2020,1
5.793010999999979,24,34,58,58,Apr-13-2020,1
3.1982748000000356,28,5,33,33,Apr-13-2020,1
1.7044409000000087,12,6,18,18,Apr-13-2020,1
5.359228699999903,42,17,59,59,Apr-13-2020,1
2.0798440999999457,1,48,49,49,Apr-13-2020,1
5.575754599999982,16,42,58,58,Apr-13-2020,1
5.137400499999785,26,8,34,34,Apr-13-2020,1
1.2860750999998345,0,0,0,0,Apr-13-2020,1
3.4639138000000003,33,20,53,53,Apr-13-2020,1
6.256290499999977,45,26,71,71,Apr-13-2020,1
1.7837478999999803,3,18,21,21,Apr-13-2020,1
6.855308299999933,49,29,78,78,Apr-13-2020,1
2.0799317999999403,1,16,17,17,Apr-13-2020,1
4.366797300000144,41,17,58,58,Apr-13-2020,1
4.311672200000203,5,21,26,26,Apr-13-2020,1
4.913007899999911,22,35,57,57,Apr-13-2020,1
4.631610099999989,15,46,61,61,Apr-13-2020,1
4.224082500000122,34,14,48,48,Apr-13-2020,1
1.7034641999998712,24,1,25,25,Apr-13-2020,1
2.4708387000000585,46,6,52,52,Apr-13-2020,1
2.1040583999999853,44,2,46,46,Apr-13-2020,1
3.784080199999835,3,21,24,24,Apr-13-2020,1
5.031158900000037,13,28,41,41,Apr-13-2020,1
2.696667499999876,4,44,48,48,Apr-13-2020,1
2.6069943999998486,10,16,26,26,Apr-13-2020,1
4.527562999999873,31,24,55,55,Apr-13-2020,1
4.064970899999935,12,14,26,26,Apr-13-2020,1
2.8229145999998764,30,33,63,63,Apr-13-2020,1
2.464122300000099,15,17,32,32,Apr-13-2020,1
3.6465210999999726,23,14,37,37,Apr-13-2020,1
3.2637161000000035,6,49,55,55,Apr-15-2020,1
4.096177300000001,41,37,78,78,Apr-15-2020,1
4.153233299999997,28,28,56,56,Apr-15-2020,1
4.327528200000003,48,47,95,95,Apr-15-2020,1
3.895934099999998,45,13,58,58,Apr-15-2020,1
1.8867073999999988,2,18,20,20,Apr-15-2020,1
2.1748908,4,30,34,34,Apr-15-2020,1
3.9764464000000004,11,35,46,46,Apr-15-2020,1
5.182558999999998,15,28,43,43,Apr-15-2020,1
1.832081500000001,15,3,18,18,Apr-15-2020,1
3.183680899999999,41,19,60,60,Apr-15-2020,1
5.9997510999999975,7,48,55,55,Apr-15-2020,1
7.128830499999992,46,9,55,55,Apr-15-2020,1
1.7589239999999933,19,0,19,19,Apr-15-2020,1
3.0554453000000024,42,9,51,49,Apr-15-2020,0
4.913029199999997,42,42,84,84,Apr-15-2020,1
3.566478100000012,11,35,46,46,Apr-15-2020,1
6.616493199999994,48,27,75,75,Apr-15-2020,1
3.9831799000000103,35,15,50,40,Apr-15-2020,0
5.2793015000000025,35,35,70,70,Apr-15-2020,1
3.432089000000005,10,39,49,49,Apr-15-2020,1
2.895536899999996,6,11,17,17,Apr-15-2020,1
4.424296699999999,14,48,62,62,Apr-15-2020,1
2.8248702999999864,16,6,22,22,Apr-15-2020,1
4.919355600000017,22,13,35,35,Apr-15-2020,1
2.4626037999999824,16,9,25,25,Apr-15-2020,1
5.456358600000016,45,17,62,62,Apr-15-2020,1
5.2155970999999965,29,48,77,77,Apr-15-2020,1
3.2648028000000124,39,20,59,59,Apr-15-2020,1
6.791249899999997,23,19,42,42,Apr-15-2020,1
1.9030047999999908,21,1,22,22,Apr-15-2020,1
3.9030360000006112,19,41,60,60,Apr-16-2020,1
3.9034750000000713,11,49,60,60,Apr-16-2020,1
7.504598900000019,33,16,49,49,Apr-16-2020,1
4.591106700000637,6,37,43,43,Apr-16-2020,1
2.215396700000383,31,30,61,61,Apr-16-2020,1
6.199922199999492,16,27,43,43,Apr-16-2020,1
3.8651582000002236,38,28,66,66,Apr-16-2020,1
2.520004699999845,30,24,54,54,Apr-16-2020,1
2.574893599999996,6,37,43,43,Apr-16-2020,1
1.8790918999993664,30,12,42,42,Apr-16-2020,1
2.63233130000026,5,31,36,36,Apr-16-2020,1
1.8871718000000328,45,1,46,46,Apr-16-2020,1
6.168507200000022,39,42,81,81,Apr-16-2020,1
4.974960600000486,19,24,43,43,Apr-16-2020,1
1.784056999999848,43,0,43,43,Apr-16-2020,1
1.056100200000401,33,0,33,33,Apr-16-2020,1
1.9514195000001564,12,7,19,19,Apr-16-2020,1
5.872843600000124,12,31,43,43,Apr-16-2020,1
1.7345322000001033,40,2,42,42,Apr-16-2020,1
2.408377400000063,19,3,22,22,Apr-16-2020,1
2.5025556000000506,28,6,34,24,Apr-16-2020,0
8.015781400000378,33,49,82,82,Apr-16-2020,1
2.0644697999996424,3,26,29,29,Apr-16-2020,1
3.2649811000001137,10,32,42,42,Apr-16-2020,1
1.7098153000006278,19,2,21,21,Apr-16-2020,1
3.840470899999673,25,28,53,52,Apr-16-2020,0
10.175192800000332,6,14,20,20,Apr-16-2020,1
3.6643679999997403,37,37,74,74,Apr-16-2020,1
4.839384500000051,45,12,57,57,Apr-16-2020,1
2.008485300000757,38,1,39,39,Apr-16-2020,1
4.047027100000378,31,37,68,68,Apr-16-2020,1
4.591980199999853,38,23,61,61,Apr-16-2020,1
1.983285700000124,38,3,41,41,Apr-16-2020,1
2.0648659000007683,8,22,30,30,Apr-16-2020,1
2.4864926000000196,15,14,29,29,Apr-16-2020,1
1.6398967000004632,2,24,26,26,Apr-16-2020,1
3.2160603000002084,11,14,25,25,Apr-16-2020,1
3.3769813999997496,18,15,33,33,Apr-16-2020,1
2.894418500000029,41,19,60,60,Apr-16-2020,1
6.767965600000025,33,22,55,55,Apr-16-2020,1
2.2637196000005133,6,32,38,38,Apr-16-2020,1
3.8479276999996728,21,26,47,47,Apr-16-2020,1
1.8236102000000756,30,11,41,41,Apr-16-2020,1
1.4801802000001771,23,3,26,26,Apr-16-2020,1
5.848070299999563,44,23,67,67,Apr-16-2020,1
2.8076939000002312,20,42,62,62,Apr-16-2020,1
4.82362060000014,19,29,48,48,Apr-16-2020,1
1.3429015000001527,4,6,10,10,Apr-16-2020,1
5.391576099999838,23,5,28,28,Apr-16-2020,1
2.8395923000007315,13,11,24,24,Apr-16-2020,1
6.720215899999857,29,47,76,76,Apr-16-2020,1
2.6642784999994547,30,39,69,69,Apr-16-2020,1
2.416854600000079,6,43,49,49,Apr-16-2020,1
6.231521000000612,46,29,75,75,Apr-16-2020,1
5.480333000000428,36,23,59,59,Apr-16-2020,1
4.277792699999736,31,29,60,60,Apr-16-2020,1
1.5113087999998243,29,0,29,29,Apr-16-2020,1
2.4487693999999465,18,7,25,25,Apr-16-2020,1
5.07157289999941,48,31,79,79,Apr-16-2020,1
7.591698700000052,30,19,49,49,Apr-16-2020,1
5.27222729999994,7,36,43,43,Apr-16-2020,1
3.264050199999474,46,11,57,57,Apr-16-2020,1
1.583667300000343,3,8,11,11,Apr-16-2020,1
2.7910592000007455,3,49,52,52,Apr-16-2020,1
5.175777399999788,21,18,39,39,Apr-16-2020,1
1.6157852999995157,8,3,11,11,Apr-16-2020,1
2.5043621999993775,40,24,64,64,Apr-16-2020,1
4.39156550000007,14,34,48,48,Apr-16-2020,1
5.416112599999906,27,17,44,44,Apr-16-2020,1
