time,num1,num2,result,answer,date,correct,score,problem_type,text_or_aloud
9.650812100000003,49,27,76,76,Oct-19-2021,1,6.861825810493528,addition,text
4.287711399999999,8,46,54,54,Oct-19-2021,1,81.61553095031005,addition,text
4.500013499999994,18,38,56,56,Oct-19-2021,1,79.7498784998178,addition,text
3.4028468000000065,5,30,35,35,Oct-19-2021,1,88.42063365572972,addition,text
6.6027393000000085,14,45,59,59,Oct-19-2021,1,56.40383373623538,addition,text
4.730865399999999,38,34,72,72,Oct-19-2021,1,77.61891256708284,addition,text
4.687918300000007,14,48,62,62,Oct-19-2021,1,78.02342201252505,addition,text
6.223028900000003,44,33,77,77,Oct-19-2021,1,61.273911309764756,addition,text
3.976365200000004,33,7,40,4,Oct-19-2021,0,0.0,addition,text
3.9147082000000064,30,14,44,44,Oct-19-2021,1,84.6750597088527,addition,text
6.192679100000008,42,38,80,80,Oct-19-2021,1,61.650725564423105,addition,text
3.1129915000000064,15,15,30,30,Oct-19-2021,1,90.30928392092771,addition,text
4.622778000000012,29,13,42,42,Oct-19-2021,1,78.62992356271589,addition,text
11.300495299999994,24,45,69,69,Oct-19-2021,1,0.0,addition,text
3.5318763000000075,30,27,57,57,Oct-19-2021,1,87.52584980149824,addition,text
3.845983199999978,45,15,60,60,Oct-19-2021,1,85.20841322531794,addition,text
4.754881100000006,22,37,59,59,Oct-19-2021,1,77.39110572486274,addition,text
3.7707263000000064,24,22,46,46,Oct-19-2021,1,85.78162317048826,addition,text
3.6285660000000064,5,32,37,37,Oct-19-2021,1,86.83350878364395,addition,text
3.8198890000000176,12,41,53,53,Oct-19-2021,1,85.40844802767887,addition,text
3.6927951999999777,34,32,66,66,Oct-19-2021,1,86.36326361085712,addition,text
3.6206477000000064,31,21,52,52,Oct-19-2021,1,86.89091023248467,addition,text
3.9712126999999953,5,33,38,38,Oct-19-2021,1,84.22946969135874,addition,text
5.6641951000000015,29,26,55,55,Oct-19-2021,1,67.91689386913598,addition,text
3.4271410000000064,14,16,30,30,Oct-19-2021,1,88.25470456611895,addition,text
3.5851130000000064,40,43,83,83,Oct-19-2021,1,87.14696477723095,addition,text
3.1813054000000136,47,7,54,54,Oct-19-2021,1,89.87929595193077,addition,text
3.486964700000016,28,11,39,39,Oct-19-2021,1,87.84107718095379,addition,text
5.619892399999998,34,25,59,59,Oct-19-2021,1,68.41680941242228,addition,text
3.3205073000000027,36,36,72,72,Oct-19-2021,1,88.97423127064671,addition,text
5.525766599999997,33,37,70,70,Oct-19-2021,1,69.46590348232448,addition,text
4.085871999999995,24,45,69,69,Oct-19-2021,1,83.30564999961605,addition,text
3.3417208000000187,8,9,17,17,Oct-19-2021,1,88.83290209484724,addition,text
2.6514397999999915,10,19,29,29,Oct-19-2021,1,92.969866986976,addition,text
4.393003300000005,30,25,55,55,Oct-19-2021,1,80.70152200618907,addition,text
2.8629444999999976,44,20,64,64,Oct-19-2021,1,91.80354878991976,addition,text
3.6833034,46,21,67,67,Oct-19-2021,1,86.43327606354845,addition,text
6.1557770000000005,18,15,33,33,Oct-19-2021,1,62.10640952627099,addition,text
2.695581300000015,19,10,29,29,Oct-19-2021,1,92.73384145509024,addition,text
6.1257382999999965,42,32,74,74,Oct-19-2021,1,62.475330279913166,addition,text
3.4882031999999867,6,17,23,23,Oct-19-2021,1,87.83243843550986,addition,text
6.133421599999991,44,8,52,52,Oct-19-2021,1,62.38113947665354,addition,text
4.8688109000000015,13,15,28,28,Oct-19-2021,1,76.29468042004119,addition,text
5.004753300000004,9,27,36,36,Oct-19-2021,1,74.95244440613907,addition,text
4.8365141000000165,15,10,25,25,Oct-19-2021,1,76.60813136050103,addition,text
4.65392810000003,43,45,88,88,Oct-19-2021,1,78.3409532400301,addition,text
3.243199800000013,5,21,26,26,Oct-19-2021,1,89.48165505727987,addition,text
8.359281500000009,46,49,95,95,Oct-19-2021,1,30.1224128037576,addition,text
4.030936800000006,21,29,50,50,Oct-19-2021,1,83.7515485144057,addition,text
7.9703693000000175,26,12,38,38,Oct-19-2021,1,36.47321322161724,addition,text
2.094539800000007,8,6,14,14,Oct-19-2021,1,95.61290302621592,addition,text
5.8883255000000085,18,29,47,47,Oct-19-2021,1,65.32762280604965,addition,text
5.073503599999995,35,21,56,56,Oct-20-2021,1,74.25956122078709,addition,text
2.4278129,8,22,30,30,Oct-20-2021,1,94.10572452259359,addition,text
4.2967801999999935,8,26,34,34,Oct-20-2021,1,81.53767991288801,addition,text
2.5158581999999967,20,17,37,37,Oct-20-2021,1,93.67045751749279,addition,text
15.439514199999998,18,34,52,52,Oct-20-2021,1,0.0,addition,text
2.416989000000001,6,18,24,24,Oct-20-2021,1,94.15816417387899,addition,text
4.5961176999999935,15,44,59,59,Oct-20-2021,1,78.87570208774676,addition,text
2.9406231999999903,30,38,68,68,Oct-20-2021,1,91.35273519562182,addition,text
2.7007862999999905,14,8,22,22,Oct-20-2021,1,92.70575336173236,addition,text
3.1068752999999987,24,35,59,59,Oct-20-2021,1,90.34732587024992,addition,text
6.3415727,33,6,39,39,Oct-20-2021,1,59.78445569061471,addition,text
3.757946699999991,46,13,59,59,Oct-20-2021,1,85.87783659995918,addition,text
5.2178466999999955,28,22,50,50,Oct-20-2021,1,72.77407581529914,addition,text
2.403991199999993,14,5,19,19,Oct-20-2021,1,94.2208263103226,addition,text
3.2447145999999947,44,41,85,85,Oct-20-2021,1,89.47182716454687,addition,text
4.156047599999994,47,37,84,84,Oct-20-2021,1,82.7272683465343,addition,text
3.6107254000000064,15,35,50,50,Oct-20-2021,1,86.96266208579479,addition,text
2.5625076999999976,25,6,31,31,Oct-20-2021,1,93.43355428744071,addition,text
4.103847999999998,46,16,62,62,Oct-20-2021,1,83.15843159289601,addition,text
3.643909100000002,48,22,70,70,Oct-20-2021,1,86.72192647093719,addition,text
3.3458966000000028,32,22,54,54,Oct-20-2021,1,88.80497594210844,addition,text
3.3019568999999933,5,11,16,16,Oct-20-2021,1,89.09708063054244,addition,text
4.486735000000009,13,34,47,47,Oct-20-2021,1,79.86920903977493,addition,text
5.223551700000002,17,8,25,25,Oct-20-2021,1,72.71450763742709,addition,text
3.7796807,21,16,37,37,Oct-20-2021,1,85.7140138060475,addition,text
3.3578679999999963,21,25,46,46,Oct-20-2021,1,88.72472249457603,addition,text
6.451367099999999,45,29,74,74,Oct-20-2021,1,58.379862541037596,addition,text
3.5035166999999774,11,36,47,47,Oct-20-2021,1,87.72537073282128,addition,text
7.245158599999996,28,29,57,57,Oct-20-2021,1,47.50767686084609,addition,text
2.2257474000000173,42,8,50,50,Oct-20-2021,1,95.04604851139317,addition,text
4.662192099999999,30,48,78,78,Oct-20-2021,1,78.26396482269759,addition,text
2.5369201999999973,24,20,44,44,Oct-20-2021,1,93.56403589883196,addition,text
1.9495313000000185,10,14,24,24,Oct-20-2021,1,96.19932771032025,addition,text
3.8694827999999855,12,42,54,54,Oct-20-2021,1,85.02710286050427,addition,text
1.8704698999999887,40,7,47,47,Oct-20-2021,1,96.50134235319405,addition,text
4.129870600000004,18,11,29,29,Oct-20-2021,1,82.94416882725561,addition,text
4.5723966999999845,29,33,62,62,Oct-20-2021,1,79.09318841782925,addition,text
4.403500699999995,49,12,61,61,Oct-20-2021,1,80.60918158509955,addition,text
6.538779900000009,22,17,39,39,Oct-20-2021,1,57.24435741935588,addition,text
2.3269626000000017,48,8,56,56,Oct-20-2021,1,94.58524505820124,addition,text
3.573573500000009,31,27,58,58,Oct-20-2021,1,87.2295724400977,addition,text
3.604853100000014,22,47,69,69,Oct-20-2021,1,87.00503412742029,addition,text
2.751935400000008,25,20,45,45,Oct-20-2021,1,92.4268515542268,addition,text
4.658737599999995,49,18,67,67,Oct-20-2021,1,78.2961639743463,addition,text
8.471801400000004,44,49,93,93,Oct-20-2021,1,28.22858103895797,addition,text
2.599798800000002,48,20,68,68,Oct-20-2021,1,93.24104619951856,addition,text
9.982931799999989,17,36,53,53,Oct-20-2021,1,0.34107267654898976,addition,text
4.231873000000006,20,31,51,51,Oct-20-2021,1,82.09125091187094,addition,text
4.626780700000012,24,15,39,39,Oct-20-2021,1,78.59290035410741,addition,text
3.862193500000018,38,38,76,76,Oct-20-2021,1,85.08346136855761,addition,text
4.841405899999983,36,14,50,50,Oct-20-2021,1,76.56078891144536,addition,text
5.909736899999999,14,49,63,63,Oct-22-2021,1,65.0750097727784,addition,text
2.299960300000002,20,11,31,31,Oct-22-2021,1,94.7101826184239,addition,text
3.6666463999999976,41,28,69,69,Oct-22-2021,1,86.55570417736706,addition,text
15.757460099999996,37,29,66,66,Oct-22-2021,1,0.0,addition,text
3.4793743000000035,13,16,29,29,Oct-22-2021,1,87.89395448049947,addition,text
3.7005580999999954,24,15,39,39,Oct-22-2021,1,86.30586974852444,addition,text
4.697812599999994,47,15,62,62,Oct-22-2021,1,77.93055677528129,addition,text
3.401268099999996,50,33,83,83,Oct-22-2021,1,88.43137531192242,addition,text
3.559380699999992,25,14,39,39,Oct-22-2021,1,87.33080903246756,addition,text
3.2201318000000043,11,33,44,44,Oct-22-2021,1,89.63075119062874,addition,text
3.660806600000001,42,49,91,91,Oct-22-2021,1,86.59849503739643,addition,text
1.8385478000000008,11,11,22,22,Oct-22-2021,1,96.61974198711515,addition,text
3.1247251000000063,8,9,17,17,Oct-22-2021,1,90.23609304942995,addition,text
8.910621999999991,18,25,43,43,Oct-22-2021,1,20.600815573116147,addition,text
8.604270200000002,37,16,53,53,Oct-22-2021,1,25.966534325391923,addition,text
4.457754899999999,12,45,57,57,Oct-22-2021,1,80.128421251526,addition,text
3.6618377000000066,12,24,36,36,Oct-22-2021,1,86.59094465885866,addition,text
3.972570900000009,31,11,42,42,Oct-22-2021,1,84.21868044447312,addition,text
2.9716325999999924,14,46,60,60,Oct-22-2021,1,91.16939969061727,addition,text
3.446715399999988,13,5,18,18,Oct-22-2021,1,88.12015295140293,addition,text
2.54789550000001,34,35,69,69,Oct-22-2021,1,93.50822852107972,addition,text
2.9978762000000074,36,30,66,66,Oct-22-2021,1,91.01273828947352,addition,text
5.489592700000002,34,17,51,51,Oct-22-2021,1,69.86437198810668,addition,text
3.2610469999999907,22,31,53,53,Oct-22-2021,1,89.36557246379107,addition,text
3.0113439000000137,35,36,71,71,Oct-22-2021,1,90.93180791593271,addition,text
8.377480100000014,33,16,49,49,Oct-22-2021,1,29.817827174103755,addition,text
4.248336899999998,39,40,79,79,Oct-22-2021,1,81.9516335840984,addition,text
2.40730499999998,15,9,24,24,Oct-22-2021,1,94.2048826369751,addition,text
5.715946900000006,19,32,51,51,Oct-22-2021,1,67.32795103638033,addition,text
3.377046799999988,8,16,24,24,Oct-22-2021,1,88.59555491060983,addition,text
5.8810611000000135,37,48,85,85,Oct-22-2021,1,65.41312033806665,addition,text
3.233748099999985,13,15,28,28,Oct-22-2021,1,89.54287322574648,addition,text
2.7230782000000042,43,8,51,51,Oct-22-2021,1,92.58484511668472,addition,text
3.5058366000000087,43,12,55,55,Oct-22-2021,1,87.70910973410038,addition,text
3.4806317999999976,44,36,80,80,Oct-22-2021,1,87.88520227282879,addition,text
3.1973840999999936,15,35,50,50,Oct-22-2021,1,89.77673491706724,addition,text
3.514045199999998,21,26,47,47,Oct-22-2021,1,87.65148633235697,addition,text
4.536952500000012,46,49,95,95,Oct-22-2021,1,79.41606201274365,addition,text
5.740569800000002,30,42,72,72,Oct-22-2021,1,67.04585837132794,addition,text
4.108834199999991,39,27,66,66,Oct-22-2021,1,83.11748151691044,addition,text
2.000806600000004,34,6,40,40,Oct-22-2021,1,95.99677294939642,addition,text
9.344851699999992,19,48,67,67,Oct-22-2021,1,12.673746705007249,addition,text
2.3150185000000083,7,12,19,19,Oct-22-2021,1,94.64068934465773,addition,text
4.046592099999998,35,24,59,59,Oct-22-2021,1,83.62509237621761,addition,text
3.5187133999999958,14,35,49,49,Oct-22-2021,1,87.61865600866047,addition,text
2.055823299999985,10,18,28,28,Oct-22-2021,1,95.77359055917715,addition,text
5.6681818000000135,47,26,73,73,Oct-22-2021,1,67.8717150821486,addition,text
3.0915687000000105,35,21,56,56,Oct-22-2021,1,90.44220297318023,addition,text
1.9539469000000047,6,40,46,46,Oct-22-2021,1,96.18209151198036,addition,text
3.2013507000000065,6,45,51,51,Oct-22-2021,1,89.75135369560948,addition,text
5.377026399999976,14,21,35,35,Oct-23-2021,1,71.0875870937033,addition,text
2.2707393000000025,9,24,33,33,Oct-23-2021,1,94.84374303143551,addition,text
7.626884799999999,23,45,68,68,Oct-23-2021,1,41.83062824752897,addition,text
3.432204000000013,12,38,50,50,Oct-23-2021,1,88.2199757023839,addition,text
4.516945600000014,47,12,59,59,Oct-23-2021,1,79.59720244664052,addition,text
3.391416499999991,41,33,74,74,Oct-23-2021,1,88.49829412352781,addition,text
4.607335000000006,35,28,63,63,Oct-23-2021,1,78.77246419777495,addition,text
5.494996699999971,47,9,56,56,Oct-23-2021,1,69.8050112669894,addition,text
4.4779059000000245,31,12,43,43,Oct-23-2021,1,79.94835875074497,addition,text
3.7892989999999998,34,14,48,48,Oct-23-2021,1,85.641213088599,addition,text
2.920396600000004,21,5,26,26,Oct-23-2021,1,91.47128369870842,addition,text
4.9223002000000236,28,37,65,65,Oct-23-2021,1,75.77096074107972,addition,text
2.618099000000001,10,48,58,58,Oct-23-2021,1,93.145557626199,addition,text
2.182104399999986,7,19,26,26,Oct-23-2021,1,95.23842038750071,addition,text
4.98498219999999,46,32,78,78,Oct-23-2021,1,75.14995246568327,addition,text
4.206404399999997,37,44,81,81,Oct-23-2021,1,82.30616202366069,addition,text
3.2935674999999947,41,47,88,88,Oct-23-2021,1,89.15241312294378,addition,text
2.9180085000000133,15,35,50,50,Oct-23-2021,1,91.48522639392769,addition,text
2.4546245999999883,45,20,65,65,Oct-23-2021,1,93.97481807307491,addition,text
4.011488100000008,18,14,32,32,Oct-23-2021,1,83.90796322355833,addition,text
2.5220871999999868,19,5,24,24,Oct-23-2021,1,93.63907615559624,addition,text
4.725759600000004,46,36,82,86,Oct-23-2021,0,0.0,addition,text
5.8849448999999945,17,47,64,64,Oct-23-2021,1,65.36742352396405,addition,text
3.1417830999999983,42,25,67,67,Oct-23-2021,1,90.1291989525544,addition,text
2.484802299999984,6,25,31,31,Oct-23-2021,1,93.8257575299148,addition,text
2.6769405999999947,40,15,55,55,Oct-23-2021,1,92.8339890240717,addition,text
6.179735100000016,15,38,53,63,Oct-23-2021,0,0.0,addition,text
5.480637900000005,45,8,53,53,Oct-23-2021,1,69.96260820908354,addition,text
4.040790600000008,50,12,62,62,Oct-23-2021,1,83.67201132695158,addition,text
3.0448962000000117,35,11,46,46,Oct-23-2021,1,90.72860713122549,addition,text
3.4176104999999954,14,43,57,57,Oct-23-2021,1,88.31993847028978,addition,text
4.300150299999984,12,18,30,30,Oct-23-2021,1,81.50870739741005,addition,text
5.139572200000032,44,34,78,78,Oct-23-2021,1,73.58479760098682,addition,text
2.6226892999999905,12,28,40,40,Oct-23-2021,1,93.12150083566557,addition,text
4.827859600000012,35,36,71,71,Oct-23-2021,1,76.69177168268773,addition,text
2.434196999999984,49,8,57,57,Oct-23-2021,1,94.07468496519108,addition,text
3.3916207999999983,11,49,60,60,Oct-23-2021,1,88.49690834900738,addition,text
5.312677600000028,18,18,36,36,Oct-23-2021,1,71.77545671845796,addition,text
7.98553290000001,34,37,71,71,Oct-23-2021,1,36.23126430301743,addition,text
3.4241329999999834,16,21,37,37,Oct-23-2021,1,88.2753131983111,addition,text
3.227666699999986,38,33,71,71,Oct-23-2021,1,89.58216767371121,addition,text
7.492647799999987,11,47,58,58,Oct-23-2021,1,43.86022894515536,addition,text
4.218744400000048,23,44,67,57,Oct-23-2021,0,0.0,addition,text
10.250914599999987,24,36,60,60,Oct-23-2021,1,0.0,addition,text
4.428005499999983,19,18,37,37,Oct-23-2021,1,80.3927672919699,addition,text
4.285512799999991,39,35,74,74,Oct-23-2021,1,81.63438004103624,addition,text
3.03657910000004,36,5,41,41,Oct-23-2021,1,90.77918736944297,addition,text
9.256370199999992,45,38,83,83,Oct-23-2021,1,14.319610720552106,addition,text
2.579664399999956,41,10,51,51,Oct-23-2021,1,93.34533158337288,addition,text
3.933434200000022,22,9,31,31,Oct-23-2021,1,84.5280953942702,addition,text
4.1228980000000215,45,47,92,92,Oct-23-2021,1,83.00171208159583,addition,text
4.9330253000000015,27,13,40,40,Oct-29-2021,1,75.6652613895599,addition,text
4.8992239999999985,44,24,68,68,Oct-29-2021,1,75.997604197824,addition,text
3.892043799999996,27,35,62,62,Oct-29-2021,1,84.8519950588816,addition,text
4.589727500000002,16,19,35,35,Oct-29-2021,1,78.93440147574373,addition,text
2.3622799999999984,8,31,39,39,Oct-29-2021,1,94.41963320159999,addition,text
2.9173707,43,42,85,85,Oct-29-2021,1,91.48894819878151,addition,text
2.8696415,30,21,51,51,Oct-29-2021,1,91.76515766147774,addition,text
2.0126586000000017,30,40,70,70,Oct-29-2021,1,95.94920535984603,addition,text
3.3523176000000063,8,34,42,42,Oct-29-2021,1,88.7619667087302,addition,text
2.9823947000000004,45,46,91,91,Oct-29-2021,1,91.10532185341192,addition,text
4.073151399999993,32,43,75,75,Oct-29-2021,1,83.4094376726781,addition,text
2.9868172999999985,46,50,96,96,Oct-29-2021,1,91.07892241642072,addition,text
2.414787099999998,9,7,16,16,Oct-29-2021,1,94.1688032616736,addition,text
2.9098704000000017,48,22,70,70,Oct-29-2021,1,91.53265425520382,addition,text
7.019945599999999,19,49,68,68,Oct-29-2021,1,50.720363773040646,addition,text
5.264873600000001,49,33,82,92,Oct-29-2021,0,0.0,addition,text
6.382285700000013,7,21,28,28,Oct-29-2021,1,59.26642924357535,addition,text
3.6815283000000094,8,49,57,57,Oct-29-2021,1,86.44634937629904,addition,text
6.357918100000006,27,48,75,75,Oct-29-2021,1,59.57687743369231,addition,text
5.0027556,28,17,45,45,Oct-29-2021,1,74.97243640666865,addition,text
5.639793299999994,11,21,32,32,Oct-29-2021,1,68.19273153327518,addition,text
2.6244748000000016,48,50,98,98,Oct-29-2021,1,93.11213202416495,addition,text
3.742805200000008,19,9,28,28,Oct-29-2021,1,85.99140923485291,addition,text
2.2646061000000093,15,30,45,45,Oct-29-2021,1,94.87155921184277,addition,text
3.3821056000000027,26,35,61,61,Oct-29-2021,1,88.56136171044862,addition,text
4.672601500000012,34,25,59,59,Oct-29-2021,1,78.16679522219763,addition,text
2.3322688000000085,8,40,48,48,Oct-29-2021,1,94.5605222445465,addition,text
2.8201104999999984,17,9,26,26,Oct-29-2021,1,92.04697676778976,addition,text
2.2573627000000163,5,11,16,16,Oct-29-2021,1,94.90431364064864,addition,text
16.261201700000015,39,49,88,88,Oct-29-2021,1,0.0,addition,text
2.72383480000002,5,34,39,39,Oct-29-2021,1,92.58072398230884,addition,text
6.583117499999987,19,12,31,31,Oct-29-2021,1,56.662563981193934,addition,text
5.7896888999999865,39,24,63,63,Oct-29-2021,1,66.47950244121694,addition,text
2.129970500000013,7,10,17,17,Oct-29-2021,1,95.4632256691297,addition,text
3.4289220999999936,33,12,45,45,Oct-29-2021,1,88.24249323213164,addition,text
2.7509047000000058,26,20,46,46,Oct-29-2021,1,92.43252333151787,addition,text
5.1322101999999745,32,41,73,73,Oct-29-2021,1,73.6604184630162,addition,text
4.394646399999999,48,47,95,95,Oct-29-2021,1,80.68708301896704,addition,text
2.6770313000000097,42,20,62,62,Oct-29-2021,1,92.83350341882027,addition,text
2.368295599999982,46,5,51,51,Oct-29-2021,1,94.39117595102071,addition,text
4.981582800000012,33,43,76,76,Oct-29-2021,1,75.18383280674405,addition,text
2.4452706999999805,27,20,47,47,Oct-29-2021,1,94.0206512037216,addition,text
10.064928399999985,37,49,86,86,Oct-29-2021,1,0.0,addition,text
4.447853699999996,47,47,94,94,Oct-29-2021,1,80.21659746339634,addition,text
1.9493927999999985,18,18,36,36,Oct-29-2021,1,96.19986771130816,addition,text
4.5198575000000005,18,47,65,65,Oct-29-2021,1,79.57088817969375,addition,text
3.2043422999999787,27,25,52,52,Oct-29-2021,1,89.73219042443085,addition,text
3.297621300000003,24,15,39,49,Oct-29-2021,0,0.0,addition,text
6.817483100000004,35,19,54,54,Oct-29-2021,1,53.521924181214345,addition,text
2.9629768000000065,8,33,41,41,Oct-29-2021,1,91.22076848266173,addition,text
6.0241379999999936,31,12,43,43,Oct-29-2021,1,63.70976135695608,addition,text
2.1218178999999964,10,23,33,33,Oct-29-2021,1,95.4978887992396,addition,text
4.3431085,49,41,90,90,Oct-29-2021,1,81.13740855722776,addition,text
7.140422699999987,24,39,63,63,Oct-29-2021,1,49.0143636653249,addition,text
4.829748300000006,26,36,62,62,Oct-29-2021,1,76.67353135864705,addition,text
6.315414700000019,18,11,29,29,Oct-29-2021,1,60.11553716702367,addition,text
2.5340876000000208,9,11,20,20,Oct-29-2021,1,93.57840003552613,addition,text
4.544763700000034,7,9,16,16,Oct-29-2021,1,79.34512291116201,addition,text
5.212048700000025,45,42,87,87,Oct-29-2021,1,72.83454834882805,addition,text
4.425471100000038,17,22,39,35,Oct-29-2021,0,0.0,addition,text
10.444930800000009,12,22,34,34,Oct-29-2021,1,0.0,addition,text
4.066005700000005,13,11,24,24,Oct-29-2021,1,83.46759764756747,addition,text
3.1883937000000064,12,22,34,34,Oct-29-2021,1,89.83414561380026,addition,text
6.501870800000006,48,34,82,82,Oct-29-2021,1,57.72567610010728,addition,text
5.0534150000000295,15,13,28,28,Oct-29-2021,1,74.46299683777471,addition,text
4.802308400000015,21,35,56,56,Oct-29-2021,1,76.9378340312893,addition,text
2.6767116999999985,28,12,40,40,Oct-29-2021,1,92.83521447508312,addition,text
9.381095200000004,36,27,63,63,Oct-29-2021,1,11.995052848536885,addition,text
3.097360600000002,11,45,56,56,Oct-29-2021,1,90.40635731356764,addition,text
6.2694369000000165,38,47,85,85,Oct-29-2021,1,60.69416095691818,addition,text
6.6831143,14,41,55,55,Oct-29-2021,1,55.33598325313552,addition,text
2.5818135000000098,45,50,95,95,Oct-29-2021,1,93.33423905121771,addition,text
8.053178799999955,18,24,42,42,Oct-29-2021,1,35.14631121523128,addition,text
5.564109799999983,44,15,59,59,Oct-29-2021,1,69.04068213354415,addition,text
4.7250346999999815,29,32,61,61,Oct-29-2021,1,77.67404708379608,addition,text
1.724605900000029,11,11,22,22,Oct-29-2021,1,97.02573448968508,addition,text
3.5034274000000214,45,47,92,97,Oct-29-2021,0,0.0,addition,text
13.1923223,15,44,59,59,Oct-29-2021,1,0.0,addition,text
6.92432070000001,27,48,75,75,Oct-29-2021,1,52.05378284355138,addition,text
3.1111779000000297,29,10,39,39,Oct-29-2021,1,90.32057207455141,addition,text
4.565725299999997,16,26,42,42,Oct-29-2021,1,79.15415248493994,addition,text
1.9917294999999624,8,10,18,18,Oct-29-2021,1,96.0330135988299,addition,text
6.216382600000031,39,49,88,88,Oct-29-2021,1,61.356587370416854,addition,text
3.8525338000000033,28,32,60,60,Oct-29-2021,1,85.15798331985755,addition,text
6.2271762999999964,31,22,53,53,Oct-29-2021,1,61.22227532871835,addition,text
1.8747477000000003,6,8,14,14,Oct-29-2021,1,96.4853210613447,addition,text
2.194968899999992,44,10,54,54,Oct-29-2021,1,95.18211152803282,addition,text
2.211692299999981,40,12,52,52,Oct-29-2021,1,95.10841717012079,addition,text
2.1010892000000467,19,5,24,24,Oct-29-2021,1,95.58542417364315,addition,text
3.5927367000000463,18,15,33,33,Oct-29-2021,1,87.09224300447279,addition,text
3.4965593000000013,20,37,57,57,Oct-29-2021,1,87.7740730615835,addition,text
2.9392295000000104,34,30,64,64,Oct-29-2021,1,91.36092994632969,addition,text
4.289049900000009,44,45,89,89,Oct-29-2021,1,81.60405095530993,addition,text
1.7474513999999886,7,7,14,14,Oct-29-2021,1,96.94641360463808,addition,text
2.5432709999999474,9,33,42,41,Oct-29-2021,0,74.12709048223707,addition,text
13.767829000000004,8,17,25,25,Oct-29-2021,1,0.0,addition,text
2.266697899999997,40,43,83,83,Oct-29-2021,1,94.8620806301356,addition,text
5.136438100000022,25,8,33,33,Oct-29-2021,1,73.61700364486815,addition,text
4.238733300000035,13,14,27,27,Oct-29-2021,1,82.03314001147079,addition,text
4.175160099999971,7,44,51,51,Oct-29-2021,1,82.56803813936824,addition,text
3.824811500000002,27,41,68,68,Oct-31-2021,1,85.37081698946774,addition,text
2.479626399999999,36,6,42,42,Oct-31-2021,1,93.85145291642306,addition,text
2.7710550000000005,6,46,52,52,Oct-31-2021,1,92.321254186975,addition,text
4.437833999999999,11,48,59,59,Oct-31-2021,1,80.305629388444,addition,text
4.330926300000002,47,31,78,78,Oct-31-2021,1,81.2430773839683,addition,text
6.021911899999999,26,18,44,44,Oct-31-2021,1,63.736577068638404,addition,text
2.5448152999999962,12,12,24,24,Oct-31-2021,1,93.52391508888591,addition,text
3.728634299999996,9,27,36,36,Oct-31-2021,1,86.09728625686355,addition,text
7.908968700000003,38,39,77,77,Oct-31-2021,1,37.448214102420266,addition,text
3.4849928999999946,25,31,56,56,Oct-31-2021,1,87.85482448694961,addition,text
2.0754599999999996,15,15,30,30,Oct-31-2021,1,95.6924657884,addition,text
3.7539625,47,22,69,69,Oct-31-2021,1,85.90776554859373,addition,text
6.519027999999999,35,15,50,50,Oct-31-2021,1,57.502273935216024,addition,text
3.4957566000000067,36,13,49,49,Oct-31-2021,1,87.77968579355641,addition,text
6.333868100000004,18,7,25,25,Oct-31-2021,1,59.88211489180234,addition,text
3.2834352,27,30,57,57,Oct-31-2021,1,89.21905328740095,addition,text
3.4108091000000087,43,46,89,89,Oct-31-2021,1,88.36638128335713,addition,text
3.646878299999997,45,35,80,80,Oct-31-2021,1,86.70027866498913,addition,text
2.8472097999999875,45,9,54,54,Oct-31-2021,1,91.89339635478404,addition,text
2.6674938000000026,7,43,50,50,Oct-31-2021,1,92.88447682696156,addition,text
1.5968327999999872,10,30,40,40,Oct-31-2021,1,97.45012500884421,addition,text
2.998963599999996,36,43,79,79,Oct-31-2021,1,91.00621732587507,addition,text
3.2428421999999983,42,18,60,60,Oct-31-2021,1,89.48397446589918,addition,text
4.3789422000000116,11,12,23,23,Oct-31-2021,1,80.82486520905907,addition,text
2.5079741999999925,6,41,47,47,Oct-31-2021,1,93.7100654121344,addition,text
2.6615757,21,5,26,26,Oct-31-2021,1,92.91601479316952,addition,text
3.1490354999999965,40,43,83,83,Oct-31-2021,1,90.08357541973976,addition,text
3.0946536999999954,41,8,49,49,Oct-31-2021,1,90.42311847707634,addition,text
3.7408487999999953,31,23,54,54,Oct-31-2021,1,86.0060502555386,addition,text
4.150636100000002,37,24,61,61,Oct-31-2021,1,82.77221996537679,addition,text
3.8419356000000136,39,23,62,72,Oct-31-2021,0,0.0,addition,text
9.424845299999989,21,39,60,60,Oct-31-2021,1,11.172291071068118,addition,text
2.425466,14,5,19,19,Oct-31-2021,1,94.117114682844,addition,text
4.8091196000000025,32,40,72,72,Oct-31-2021,1,76.87236867289582,addition,text
3.992827299999988,30,23,53,53,Oct-31-2021,1,84.0573301523748,addition,text
2.4047886999999832,42,10,52,52,Oct-31-2021,1,94.21699130835242,addition,text
3.7429579999999874,15,18,33,33,Oct-31-2021,1,85.99026541023609,addition,text
4.07119209999999,25,31,56,56,Oct-31-2021,1,83.42539488489767,addition,text
3.875122900000009,17,20,37,37,Oct-31-2021,1,84.98342250989552,addition,text
4.233079900000006,43,17,60,60,Oct-31-2021,1,82.08103456021594,addition,text
4.283791800000017,50,31,81,81,Oct-31-2021,1,81.64912781425261,addition,text
6.754817900000006,27,27,54,54,Oct-31-2021,1,54.37243513783951,addition,text
4.878912700000001,34,37,71,71,Oct-31-2021,1,76.19621086577871,addition,text
5.3374922999999805,17,19,36,36,Oct-31-2021,1,71.51117594744092,addition,text
2.463884500000006,30,21,51,51,Oct-31-2021,1,93.92927317065971,addition,text
7.264933899999987,23,42,65,65,Oct-31-2021,1,47.220735428630974,addition,text
8.384775099999986,8,15,23,23,Oct-31-2021,1,29.695546522420216,addition,text
3.8260097000000144,48,34,82,82,Oct-31-2021,1,85.3616497755058,addition,text
3.5518074000000013,12,45,57,57,Oct-31-2021,1,87.38466419330523,addition,text
1.910615999999976,7,43,50,50,Oct-31-2021,1,96.3495465005441,addition,text
4.387229500000018,27,43,70,80,Oct-31-2021,0,0.0,addition,text
14.084135399999981,24,43,67,67,Oct-31-2021,1,0.0,addition,text
2.8969329999999904,40,49,89,89,Oct-31-2021,1,91.60777919351105,addition,text
3.7789224999999935,13,46,59,59,Oct-31-2021,1,85.7197447389938,addition,text
6.6775999000000175,13,47,60,60,Oct-31-2021,1,55.40965957551976,addition,text
2.206224099999986,48,40,88,88,Oct-31-2021,1,95.13257522057926,addition,text
3.335686100000004,11,43,54,54,Oct-31-2021,1,88.87319824226677,addition,text
12.246953199999998,49,36,85,85,Oct-31-2021,1,0.0,addition,text
2.715398399999998,14,9,23,23,Oct-31-2021,1,92.62661152927744,addition,text
3.698908100000004,24,34,58,58,Oct-31-2021,1,86.31807886775438,addition,text
4.9333314,42,49,91,91,Oct-31-2021,1,75.66224129777405,addition,text
5.501932699999999,16,35,51,51,Oct-31-2021,1,69.72873656467073,addition,text
4.0181140000000015,10,15,25,25,Oct-31-2021,1,83.854759883004,addition,text
2.228102700000001,49,40,89,89,Nov-03-2021,True,95.0355583582527,addition,text
2.4194466000000006,11,43,54,54,Nov-03-2021,True,94.14627814974844,addition,text
2.263278300000003,48,12,60,60,Nov-03-2021,True,94.8775713367491,addition,text
3.5839466999999985,11,18,29,29,Nov-03-2021,True,87.15532605155911,addition,text
3.5518228000000036,12,17,29,29,Nov-03-2021,True,87.38455479740014,addition,text
4.726997599999997,25,29,54,54,Nov-03-2021,True,77.65549368959427,addition,text
2.6077486000000007,21,50,71,71,Nov-03-2021,True,93.19964723919804,addition,text
2.9129295999999982,21,28,49,49,Nov-03-2021,True,91.51484114544385,addition,text
4.942303799999991,9,46,55,55,Nov-03-2021,True,75.57363314850565,addition,text
6.903759600000001,47,46,93,93,Nov-03-2021,True,52.33810338540783,addition,text
7.216293899999997,32,15,47,57,Nov-03-2021,False,0.0,addition,text
2.368068799999989,6,10,16,16,Nov-03-2021,True,94.39225015846661,addition,text
5.790607800000004,27,37,64,67,Nov-03-2021,False,0.0,addition,text
2.0321270999999967,40,8,48,48,Nov-03-2021,True,95.8704594494456,addition,text
3.8795202000000018,32,27,59,59,Nov-03-2021,True,84.94932301779195,addition,text
2.879345999999998,23,23,46,46,Nov-03-2021,True,91.70936661228401,addition,text
3.855911599999999,42,32,74,74,Nov-03-2021,True,85.13194573298544,addition,text
5.648510299999998,39,29,68,68,Nov-03-2021,True,68.09433139079394,addition,text
6.24683069999999,34,41,75,75,Nov-03-2021,True,60.97710620553764,addition,text
2.759440500000011,37,11,48,48,Nov-03-2021,True,92.38548812695969,addition,text
2.4485671000000053,5,9,14,14,Nov-03-2021,True,94.00451915679756,addition,text
3.279264900000001,46,26,72,72,Nov-03-2021,True,89.24642171562799,addition,text
3.5835799000000037,19,9,28,28,Nov-03-2021,True,87.15795510031596,addition,text
6.656193799999997,28,19,47,47,Nov-03-2021,True,55.6950840968416,addition,text
3.3443050999999855,22,13,35,35,Nov-03-2021,True,88.81562339811408,addition,text
6.158474300000023,36,19,55,55,Nov-03-2021,True,62.07319429623923,addition,text
4.559614900000014,32,33,65,65,Nov-03-2021,True,79.20991196369786,addition,text
3.8715932000000066,48,18,66,66,Nov-03-2021,True,85.01076609371371,addition,text
3.5678986000000066,46,22,68,68,Nov-03-2021,True,87.270099580118,addition,text
3.671854599999989,28,11,39,39,Nov-03-2021,True,86.51748379645892,addition,text
7.199358399999994,7,16,23,25,Nov-03-2021,False,0.0,addition,text
9.942836699999987,32,35,67,67,Nov-03-2021,True,1.1399983571333792,addition,text
2.936890699999992,28,9,37,37,Nov-03-2021,True,91.37467301625355,addition,text
6.335648600000013,48,13,61,61,Nov-03-2021,True,59.85955681731787,addition,text
2.5673438999999973,49,7,56,56,Nov-03-2021,True,93.4087452991328,addition,text
6.6399842999999805,6,47,53,53,Nov-03-2021,True,55.91060849575377,addition,text
3.4632774999999754,45,32,77,77,Nov-03-2021,True,88.00570895799392,addition,text
4.240154599999983,41,39,80,80,Nov-03-2021,True,82.02108896809898,addition,text
4.959836800000005,34,39,73,73,Nov-03-2021,True,75.40001891736571,addition,text
7.406483199999997,39,21,60,60,Nov-03-2021,True,45.144006608117806,addition,text
2.4318980999999837,13,7,20,20,Nov-03-2021,True,94.08587163121646,addition,text
6.759614999999997,28,19,47,74,Nov-03-2021,False,0.0,addition,text
9.402659100000022,31,45,76,76,Nov-03-2021,True,11.590001849186763,addition,text
4.877035699999993,32,48,80,80,Nov-03-2021,True,76.21452278092558,addition,text
2.4156307000000083,10,31,41,41,Nov-03-2021,True,94.16472832121747,addition,text
8.520080199999995,19,12,31,31,Nov-03-2021,True,27.40823338556804,addition,text
7.1996646000000055,15,25,40,40,Nov-03-2021,True,48.164829647506764,addition,text
2.1528008999999884,45,6,51,51,Nov-03-2021,True,95.36544828495924,addition,text
3.7345240000000217,37,35,72,72,Nov-03-2021,True,86.05333049342384,addition,text
4.816336100000001,31,39,70,70,Nov-03-2021,True,76.80290657183679,addition,text
4.814407299999999,38,24,62,62,Nov-04-2021,True,76.82148234970671,addition,text
4.161338399999998,13,33,46,46,Nov-04-2021,True,82.68326272068546,addition,text
5.007714899999996,26,5,31,31,Nov-04-2021,True,74.92279148031803,addition,text
2.433251400000003,14,16,30,30,Nov-04-2021,True,94.07928762439802,addition,text
4.345442900000002,39,34,73,73,Nov-04-2021,True,81.11712600283957,addition,text
2.509608,18,9,27,27,Nov-04-2021,True,93.701867686336,addition,text
4.8768916,47,26,73,63,Nov-04-2021,False,0.0,addition,text
9.3409306,38,13,51,51,Nov-04-2021,True,12.747015525983642,addition,text
4.433389200000001,37,25,62,62,Nov-04-2021,True,80.34506020132335,addition,text
7.058684399999997,13,42,55,55,Nov-04-2021,True,50.17497454119668,addition,text
3.2099626999999913,14,16,30,30,Nov-04-2021,True,89.69613946460876,addition,text
3.7844159000000133,26,46,72,72,Nov-04-2021,True,85.67819629582709,addition,text
3.751321500000003,13,5,18,18,Nov-04-2021,True,85.92758700363773,addition,text
2.5102681000000047,20,31,51,51,Nov-04-2021,True,93.69855406612237,addition,text
2.1536720999999943,46,5,51,51,Nov-04-2021,True,95.36169648568162,addition,text
10.269167199999998,22,43,65,65,Nov-04-2021,True,0.0,addition,text
4.652020399999998,46,34,80,80,Nov-04-2021,True,78.35870619798386,addition,text
5.6661225,37,11,48,48,Nov-04-2021,True,67.89505581499375,addition,text
3.2907048000000003,35,16,51,51,Nov-04-2021,True,89.17126191925696,addition,text
5.4035968000000025,42,21,63,63,Nov-04-2021,True,70.80114162302974,addition,text
4.162758300000007,27,47,74,74,Nov-04-2021,True,82.67144333578105,addition,text
2.210392099999993,40,7,47,47,Nov-04-2021,True,95.11416676425762,addition,text
5.570581000000004,41,34,75,75,Nov-04-2021,True,68.96862732243895,addition,text
2.6476563000000084,7,40,47,47,Nov-04-2021,True,92.98991611707027,addition,text
3.3515352999999948,15,45,60,60,Nov-04-2021,True,88.76721113285394,addition,text
3.961194500000005,39,44,83,83,Nov-04-2021,True,84.3089381331697,addition,text
3.7335671999999818,40,38,78,78,Nov-04-2021,True,86.0604759630843,addition,text
3.143920800000018,26,25,51,51,Nov-04-2021,True,90.11576200332725,addition,text
1.9758811000000094,12,6,18,18,Nov-04-2021,True,96.09589387866275,addition,text
4.175834600000002,16,22,38,38,Nov-04-2021,True,82.56240539344283,addition,text
3.5733803999999907,38,33,71,71,Nov-04-2021,True,87.23095251689591,addition,text
2.358741500000008,9,21,30,30,Nov-04-2021,True,94.43633853617771,addition,text
3.32882459999999,21,31,52,52,Nov-04-2021,True,88.91892678243491,addition,text
5.692670100000015,44,36,80,80,Nov-04-2021,True,67.59350713256582,addition,text
4.154724799999997,31,25,56,56,Nov-04-2021,True,82.73826183626498,addition,text
5.5268958999999995,39,29,68,68,Nov-04-2021,True,69.45342171056319,addition,text
5.743422500000008,19,48,67,67,Nov-04-2021,True,67.01309798649365,addition,text
2.98476389999999,40,33,73,73,Nov-04-2021,True,91.09118446125684,addition,text
3.4600160000000244,46,24,70,70,Nov-04-2021,True,88.02828927974383,addition,text
2.9816433000000018,7,24,31,31,Nov-04-2021,True,91.1098032315651,addition,text
4.688562999999988,12,43,55,55,Nov-04-2021,True,78.01737699503111,addition,text
2.0528625999999974,5,20,25,25,Nov-04-2021,True,95.78575514552125,addition,text
4.140147100000007,22,38,60,60,Nov-04-2021,True,82.85918199036153,addition,text
2.783399299999985,40,50,90,90,Nov-04-2021,True,92.25268833675959,addition,text
3.7689392000000055,11,41,52,52,Nov-04-2021,True,85.79509730670333,addition,text
4.736102999999986,6,49,55,55,Nov-04-2021,True,77.56932837339113,addition,text
2.9263922000000093,6,31,37,37,Nov-04-2021,True,91.4362286917791,addition,text
2.818352599999997,8,38,46,46,Nov-04-2021,True,92.05688862207326,addition,text
5.395709899999986,13,36,49,49,Nov-04-2021,True,70.88631467504214,addition,text
12.532842700000003,37,48,85,85,Nov-04-2021,True,0.0,addition,text
2.3348770000000005,5,14,19,19,Nov-07-2021,True,94.548349394871,addition,text
3.944627500000001,35,42,77,77,Nov-07-2021,True,84.43991388624374,addition,text
4.579106100000002,16,36,52,52,Nov-07-2021,True,79.03178732494277,addition,text
3.4675487999999994,32,19,51,51,Nov-07-2021,True,87.97610531961857,addition,text
4.292051700000002,45,37,82,82,Nov-07-2021,True,81.57829220452709,addition,text
2.060879800000002,12,6,18,18,Nov-07-2021,True,95.75277444995196,addition,text
3.4052775000000004,7,38,45,45,Nov-07-2021,True,88.40408514799375,addition,text
4.233401000000001,44,48,92,92,Nov-07-2021,True,82.078315973199,addition,text
5.638566699999998,25,34,59,59,Nov-07-2021,True,68.20656556965113,addition,text
2.0078159999999983,7,21,28,28,Nov-07-2021,True,95.968674910144,addition,text
3.527516200000001,6,47,53,53,Nov-07-2021,True,87.55662945873755,addition,text
2.3887001999999953,7,33,40,40,Nov-07-2021,True,94.29411135451998,addition,text
2.1642299999999963,50,12,62,62,Nov-07-2021,True,95.31610850710001,addition,text
2.1677377999999976,21,6,27,27,Nov-07-2021,True,95.30091283045117,addition,text
2.713388799999997,9,5,14,14,Nov-07-2021,True,92.63752122003457,addition,text
4.901053999999995,47,16,63,63,Nov-07-2021,True,75.97966968908405,addition,text
1.7300250999999989,6,10,16,16,Nov-07-2021,True,97.00701315337,addition,text
3.528345199999997,5,18,23,23,Nov-07-2021,True,87.55078014963698,addition,text
3.407767800000002,43,31,74,74,Nov-07-2021,True,88.38711862128315,addition,text
5.108697300000003,37,36,73,73,Nov-07-2021,True,73.90121189697268,addition,text
1.9141611999999952,10,16,26,26,Nov-08-2021,True,96.33598690041458,addition,text
1.986626799999982,26,10,36,36,Nov-08-2021,True,96.05331395752184,addition,text
4.410117200000002,15,38,53,53,Nov-08-2021,True,80.55086628226414,addition,text
2.6495588000000225,10,37,47,47,Nov-08-2021,True,92.97983816534244,addition,text
2.9027237999999898,22,41,63,63,Nov-08-2021,True,91.57419454091362,addition,text
6.259215500000039,45,29,74,74,Nov-08-2021,True,60.822221324559266,addition,text
3.8251391000000012,37,25,62,62,Nov-08-2021,True,85.36831086565118,addition,text
3.2100095000000124,24,42,66,66,Nov-08-2021,True,89.69583900990968,addition,text
4.679536499999983,49,27,76,76,Nov-08-2021,True,78.1019381451679,addition,text
2.5426782999999773,9,7,16,16,Nov-08-2021,True,93.53478706270923,addition,text
3.6323572000000013,13,42,55,55,Nov-08-2021,True,86.80598117160815,addition,text
4.0410933,19,15,34,34,Nov-08-2021,True,83.66956494069511,addition,text
1.9780524000000241,30,14,44,44,Nov-08-2021,True,96.08730870285414,addition,text
3.5417747999999847,13,35,48,48,Nov-08-2021,True,87.45583126608507,addition,text
2.4677839999999946,14,14,28,28,Nov-08-2021,True,93.91004212934402,addition,text
3.1770453999999972,15,31,46,46,Nov-08-2021,True,89.90638252633886,addition,text
3.2052631999999903,17,47,64,64,Nov-08-2021,True,89.72628781872582,addition,text
3.95006410000002,46,36,82,82,Nov-08-2021,True,84.39699360589103,addition,text
3.4816238999999882,43,33,76,86,Nov-08-2021,False,0.0,addition,text
5.33239279999998,31,27,58,58,Nov-08-2021,True,71.56558702650838,addition,text
4.265525500000024,38,43,81,81,Nov-08-2021,True,81.80529220884955,addition,text
3.590391400000044,23,11,34,34,Nov-08-2021,True,87.10908959480572,addition,text
4.053951700000027,17,32,49,49,Nov-08-2021,True,83.56547561406688,addition,text
3.5449598999999807,31,43,74,74,Nov-08-2021,True,87.43325930739212,addition,text
2.6943423000000166,30,39,69,69,Nov-08-2021,True,92.74051957043062,addition,text
4.611217500000009,16,27,43,43,Nov-08-2021,True,78.73667316769367,addition,text
4.7610361000000125,18,43,61,61,Nov-08-2021,True,77.33253525449666,addition,text
3.42667560000001,35,20,55,55,Nov-08-2021,True,88.25789433236457,addition,text
3.715241400000025,46,48,94,94,Nov-08-2021,True,86.19698133972585,addition,text
4.220640599999967,7,48,55,55,Nov-08-2021,True,82.18619292563191,addition,text
7.612611800000025,45,32,77,77,Nov-08-2021,True,42.048141582500385,addition,text
3.9443181000000322,23,43,66,66,Nov-08-2021,True,84.44235472601214,addition,text
4.06444590000001,50,35,85,85,Nov-08-2021,True,83.48027952597312,addition,text
3.9774401999999895,17,47,64,64,Nov-08-2021,True,84.17996945542404,addition,text
7.064265299999988,39,44,83,83,Nov-08-2021,True,50.096155771216075,addition,text
5.375042299999961,35,42,77,77,Nov-08-2021,True,71.10892027321113,addition,text
3.7069521000000236,38,43,81,81,Nov-08-2021,True,86.25850612830541,addition,text
4.122389999999996,39,33,72,72,Nov-08-2021,True,83.00590068790004,addition,text
2.777380999999991,20,13,33,33,Nov-08-2021,True,92.28615478083906,addition,text
2.7070805000000178,30,41,71,71,Nov-08-2021,True,92.67171516651965,addition,text
3.13271119999996,48,9,57,57,Nov-08-2021,True,90.18612053739481,addition,text
4.081975199999988,43,35,78,78,Nov-08-2021,True,83.33747846658505,addition,text
5.16675140000001,49,44,93,93,Nov-08-2021,True,73.30467997059795,addition,text
2.7653581000000145,21,22,43,43,Nov-08-2021,True,92.3527945787643,addition,text
5.707383200000038,45,17,62,72,Nov-08-2021,False,0.0,addition,text
5.81327970000001,36,30,66,66,Nov-08-2021,True,66.2057791295678,addition,text
2.4213409000000183,8,11,19,19,Nov-08-2021,True,94.13710824598711,addition,text
2.181889599999977,50,11,61,61,Nov-08-2021,True,95.23935777341194,addition,text
2.3647088999999823,10,47,57,57,Nov-08-2021,True,94.40815181826088,addition,text
5.579526600000008,37,39,76,76,Nov-08-2021,True,68.86888291989234,addition,text
3.10536239999999,11,47,58,58,Nov-08-2021,True,90.3567243646663,addition,text
5.098881100000028,46,18,64,64,Nov-08-2021,True,74.0014115280625,addition,text
2.332627899999977,46,5,51,51,Nov-08-2021,True,94.5588470801417,addition,text
4.521936100000005,25,27,52,52,Nov-08-2021,True,79.55209390751675,addition,text
5.735770599999967,45,29,74,74,Nov-08-2021,True,67.10093562417603,addition,text
5.656705400000021,37,48,85,85,Nov-08-2021,True,68.0016840176106,addition,text
2.144678900000031,29,10,39,39,Nov-08-2021,True,95.40035241589466,addition,text
2.6445603000000233,8,23,31,31,Nov-08-2021,True,93.00630081966379,addition,text
2.09156999999999,5,25,30,30,Nov-08-2021,True,95.62533493510004,addition,text
1.9130857000000105,33,10,43,43,Nov-08-2021,True,96.34010310445547,addition,text
3.4143918999999983,21,37,58,58,Nov-08-2021,True,88.3419279532144,addition,text
4.500455699999975,39,43,82,82,Nov-08-2021,True,79.74589849233773,addition,text
3.4720902999999907,37,38,75,75,Nov-08-2021,True,87.94458894864597,addition,text
2.4942505999999867,9,25,34,34,Nov-08-2021,True,93.77871394439971,addition,text
5.807727199999988,18,49,67,67,Nov-08-2021,True,66.2703047703803,addition,text
5.17461209999999,35,46,81,81,Nov-08-2021,True,73.22338961453369,addition,text
2.8724917999999775,42,22,64,64,Nov-08-2021,True,91.74879085893289,addition,text
4.340105999999992,47,32,79,79,Nov-08-2021,True,81.16347990876407,addition,text
3.1894558999999845,22,12,34,34,Nov-08-2021,True,89.82737106195529,addition,text
4.236001299999941,22,25,47,47,Nov-08-2021,True,82.0562929863988,addition,text
5.558552799999916,29,42,71,71,Nov-08-2021,True,69.1024907696131,addition,text
4.387312999999949,31,16,47,47,Nov-08-2021,True,80.75148464003145,addition,text
3.4957774000000654,23,6,29,29,Nov-08-2021,True,87.77954036964879,addition,text
2.3938817000000014,29,5,34,34,Nov-09-2021,True,94.2693304064051,addition,text
4.227710900000002,35,35,70,70,Nov-09-2021,True,82.12646054602118,addition,text
2.3348464,16,15,31,31,Nov-09-2021,True,94.54849228840703,addition,text
10.094036999999997,17,45,62,62,Nov-09-2021,True,0.0,addition,text
2.498868199999997,8,31,39,39,Nov-09-2021,True,93.75565771902878,addition,text
3.948474500000003,38,17,55,55,Nov-09-2021,True,84.40954912284973,addition,text
3.2295970999999994,12,33,45,45,Nov-09-2021,True,89.5697025716716,addition,text
3.339997200000006,32,5,37,37,Nov-09-2021,True,88.84441870399212,addition,text
2.739242300000001,27,21,48,48,Nov-09-2021,True,92.4965516218907,addition,text
3.2115063000000035,29,25,54,54,Nov-09-2021,True,89.68622728506028,addition,text
5.2241146,13,31,44,44,Nov-09-2021,True,72.70862664606685,addition,text
3.786483799999999,45,42,87,87,Nov-09-2021,True,85.66254043233756,addition,text
4.309190099999995,28,43,71,71,Nov-09-2021,True,81.43088068206202,addition,text
7.047801300000003,19,23,42,42,Nov-09-2021,True,50.32849683571826,addition,text
4.300112600000006,50,19,69,69,Nov-09-2021,True,81.50903162732119,addition,text
2.632146200000008,32,10,42,42,Nov-09-2021,True,93.07180638182551,addition,text
5.261163199999999,26,15,41,41,Nov-09-2021,True,72.32016178296578,addition,text
5.3823341000000084,25,30,55,55,Nov-09-2021,True,71.0304796359771,addition,text
4.496121000000002,13,16,29,29,Nov-09-2021,True,79.78489595335898,addition,text
3.068292200000002,45,43,88,88,Nov-09-2021,True,90.58558297541914,addition,text
3.7055672000000044,32,39,71,71,Nov-09-2021,True,86.26877172628413,addition,text
2.93785290000001,21,50,71,71,Nov-09-2021,True,91.36902033796153,addition,text
5.810404299999988,33,50,83,83,Nov-09-2021,True,66.23920187054165,addition,text
3.3923891999999967,29,11,40,40,Nov-09-2021,True,88.49169551572338,addition,text
4.023795000000007,49,31,80,80,Nov-09-2021,True,83.80907379797495,addition,text
2.7666835999999932,20,45,65,65,Nov-09-2021,True,92.34546185749107,addition,text
3.319271900000004,47,44,91,91,Nov-09-2021,True,88.98243405387036,addition,text
5.240055899999987,11,26,37,37,Nov-09-2021,True,72.54181416487532,addition,text
3.2256371,27,11,38,38,Nov-09-2021,True,89.59526529910359,addition,text
3.9256951999999785,23,21,44,44,Nov-09-2021,True,84.58891719669712,addition,text
2.768361199999987,22,10,32,32,Nov-09-2021,True,92.33617626633463,addition,text
4.034646900000013,20,36,56,56,Nov-09-2021,True,83.72162439232028,addition,text
3.225170200000008,20,42,62,62,Nov-09-2021,True,89.5982771810319,addition,text
2.8696825000000104,16,9,25,25,Nov-09-2021,True,91.7649223491937,addition,text
2.1526778999999863,12,12,24,24,Nov-09-2021,True,95.36597785885165,addition,text
3.9053215000000137,23,15,38,38,Nov-09-2021,True,84.74846398163764,addition,text
7.633540100000005,17,42,59,59,Nov-09-2021,True,41.72906554169192,addition,text
7.381835099999989,48,25,73,73,Nov-09-2021,True,45.50851055640815,addition,text
3.8282383000000095,45,42,87,87,Nov-09-2021,True,85.34459151841304,addition,text
3.671329799999995,32,9,41,41,Nov-09-2021,True,86.521337499632,addition,text
2.0828578999999934,10,35,45,45,Nov-09-2021,True,95.66170296840761,addition,text
1.8968116000000066,9,50,59,59,Nov-09-2021,True,96.40210575410542,addition,text
4.612389400000012,14,39,53,53,Nov-09-2021,True,78.72586402276752,addition,text
6.722435499999989,7,25,32,32,Nov-09-2021,True,54.8088609483399,addition,text
4.601423000000011,16,44,60,60,Nov-09-2021,True,78.8269063750709,addition,text
3.250852899999984,15,22,37,37,Nov-09-2021,True,89.4319554225617,addition,text
2.94420310000001,24,11,35,35,Nov-09-2021,True,91.33166810595033,addition,text
2.882234899999986,16,40,56,56,Nov-09-2021,True,91.69272198122206,addition,text
2.4112685000000056,50,14,64,64,Nov-09-2021,True,94.18578422090772,addition,text
2.0754516999999737,40,40,80,80,Nov-09-2021,True,95.69250024096722,addition,text
2.7486332000000004,18,12,30,30,Nov-09-2021,True,92.44501553185776,addition,text
2.5293156999999837,13,9,22,21,Nov-09-2021,False,74.41024835893437,addition,text
5.673357400000015,34,27,61,61,Nov-09-2021,True,67.81301581186507,addition,text
9.702948300000003,22,21,43,43,Nov-09-2021,True,5.852794287527061,addition,text
4.147769600000004,21,6,27,27,Nov-09-2021,True,82.79600734531581,addition,text
4.887247200000019,28,50,78,78,Nov-09-2021,True,76.11481480609197,addition,text
2.7543474999999944,22,20,42,42,Nov-09-2021,True,92.41356984924379,addition,text
4.113833499999998,17,27,44,44,Nov-09-2021,True,83.07637393427777,addition,text
3.6658095999999887,24,15,39,39,Nov-09-2021,True,86.56183997654793,addition,text
3.249060700000001,41,38,79,79,Nov-09-2021,True,89.4436045677155,addition,text
2.7478049000000055,32,30,62,62,Nov-09-2021,True,92.44956823153596,addition,text
3.9470373999999993,36,49,85,85,Nov-09-2021,True,84.42089576300124,addition,text
3.0507704999999987,15,24,39,39,Nov-09-2021,True,90.69279935632976,addition,text
2.3031093999999825,20,11,31,31,Nov-09-2021,True,94.69568709163173,addition,text
5.627827200000013,41,12,53,53,Nov-09-2021,True,68.32756100694002,addition,text
3.7961226000000465,34,7,41,41,Nov-09-2021,True,85.58945320576889,addition,text
4.260261999999955,23,42,65,75,Nov-09-2021,False,0.0,addition,text
7.804938499999992,26,36,62,62,Nov-09-2021,True,39.082935011217884,addition,text
2.852116599999988,24,20,44,44,Nov-09-2021,True,91.86543090000451,addition,text
3.599811499999987,37,5,42,42,Nov-09-2021,True,87.04135716446784,addition,text
3.320191199999954,42,33,75,75,Nov-09-2021,True,88.97633039544287,addition,text
3.5961671000000024,5,48,53,53,Nov-09-2021,True,87.06758218887757,addition,text
7.891001900000049,25,28,53,53,Nov-09-2021,True,37.732089014195616,addition,text
5.557823900000017,37,12,49,49,Nov-09-2021,True,69.1105934965886,addition,text
4.180218000000025,30,24,54,54,Nov-09-2021,True,82.5257774724758,addition,text
3.958175600000004,49,47,96,96,Nov-09-2021,True,84.3328459195646,addition,text
4.939397000000042,43,5,48,48,Nov-09-2021,True,75.60235727639058,addition,text
3.560036200000013,27,47,74,74,Nov-09-2021,True,87.32614225468947,addition,text
6.529627099999971,26,24,50,50,Nov-09-2021,True,57.36396993494598,addition,text
7.268808799999988,25,18,43,43,Nov-09-2021,True,47.164418629042736,addition,text
4.305643900000007,5,32,37,37,Nov-09-2021,True,81.46143060639272,addition,text
3.1390064999999936,41,36,77,77,Nov-09-2021,True,90.1466381929578,addition,text
3.623595600000044,26,22,48,48,Nov-09-2021,True,86.86955492766032,addition,text
3.93125550000002,43,31,74,74,Nov-09-2021,True,84.54523019371959,addition,text
5.663142100000016,25,46,71,71,Nov-09-2021,True,67.9288215552074,addition,text
5.557528499999989,30,49,79,79,Nov-09-2021,True,69.11387697168787,addition,text
2.216857800000014,36,5,41,41,Nov-09-2021,True,95.0855414945791,addition,text
4.3521403000000305,48,6,54,54,Nov-09-2021,True,81.05887480911565,addition,text
3.5131955999999605,43,43,86,86,Nov-09-2021,True,87.65745667614092,addition,text
7.0815503000000035,23,50,73,83,Nov-09-2021,False,0.0,addition,text
2.277701400000012,11,50,61,61,Nov-09-2021,True,94.81207633243798,addition,text
13.877976200000035,35,5,40,40,Nov-09-2021,True,0.0,addition,text
11.29636290000002,24,33,57,57,Nov-09-2021,True,0.0,addition,text
4.219550500000025,17,21,38,38,Nov-09-2021,True,82.19539357794955,addition,text
4.191427400000009,27,23,50,50,Nov-09-2021,True,82.43193635052916,addition,text
2.901234499999987,7,29,36,36,Nov-09-2021,True,91.58283837600983,addition,text
4.82450080000001,28,44,72,72,Nov-09-2021,True,76.72419203079926,addition,text
2.913216900000009,9,35,44,44,Nov-09-2021,True,91.51316729355433,addition,text
3.8387284000000363,37,17,54,54,Nov-09-2021,True,85.26416427103317,addition,text
3.042117899999994,31,8,39,39,Nov-09-2021,True,90.74551868249962,addition,text
4.209348200000001,39,45,84,84,Nov-13-2021,True,82.28138773115676,addition,text
3.309699600000002,36,14,50,50,Nov-13-2021,True,89.04588855775982,addition,text
3.419675399999999,40,16,56,56,Nov-13-2021,True,88.30582015863484,addition,text
4.398762399999999,33,23,56,56,Nov-13-2021,True,80.65088934834625,addition,text
6.865546899999998,27,45,72,72,Nov-13-2021,True,52.86426576390041,addition,text
3.771355700000001,26,34,60,60,Nov-13-2021,True,85.77687618407751,addition,text
2.9340940000000018,5,27,32,32,Nov-13-2021,True,91.391092399164,addition,text
3.7044403000000017,27,41,68,68,Nov-13-2021,True,86.2771220637359,addition,text
2.1365842000000015,11,5,16,16,Nov-13-2021,True,95.43500795631036,addition,text
6.4378129999999985,34,8,42,42,Nov-13-2021,True,58.55456377703102,addition,text
2.4563342000000006,30,28,58,58,Nov-13-2021,True,93.96642229791036,addition,text
6.962137599999991,16,45,61,61,Nov-13-2021,True,51.52864003866636,addition,text
3.0947283,18,38,56,56,Nov-13-2021,True,90.42265674917911,addition,text
4.359544,42,38,80,80,Nov-13-2021,True,80.994376112064,addition,text
8.192672399999992,23,44,67,67,Nov-13-2021,True,32.88011894627837,addition,text
3.5116428999999982,46,8,54,54,Nov-13-2021,True,87.6683641428796,addition,text
3.5866503000000023,13,25,38,38,Nov-13-2021,True,87.13593962550989,addition,text
2.8305651999999952,18,50,68,68,Nov-13-2021,True,91.98790064854899,addition,text
2.212538699999996,5,16,21,21,Nov-13-2021,True,95.10467250100233,addition,text
4.256888899999993,37,42,79,79,Nov-13-2021,True,81.87889689305685,addition,text
2.5007717999999954,6,21,27,27,Nov-13-2021,True,93.74614040432478,addition,text
7.9443919999999935,17,26,43,43,Nov-13-2021,True,36.886635750336104,addition,text
2.349773600000006,50,17,67,67,Nov-13-2021,True,94.47856402874301,addition,text
3.070057899999995,41,30,71,71,Nov-13-2021,True,90.57474449064762,addition,text
2.282033900000002,16,50,66,66,Nov-13-2021,True,94.79232127925079,addition,text
2.999654399999997,44,23,67,67,Nov-13-2021,True,91.00207348056065,addition,text
1.8862434000000121,5,15,20,20,Nov-13-2021,True,96.44208583595639,addition,text
6.391801299999983,26,38,64,64,Nov-13-2021,True,59.14487614131853,addition,text
3.7655176000000097,25,21,46,46,Nov-13-2021,True,85.82087720409017,addition,text
3.454829899999993,18,23,41,41,Nov-13-2021,True,88.06415036206604,addition,text
2.384552300000024,21,10,31,31,Nov-13-2021,True,94.31391032856459,addition,text
2.3408112000000187,11,22,33,33,Nov-13-2021,True,94.52060292595448,addition,text
5.4026687999999865,23,38,61,61,Nov-13-2021,True,70.81116983750671,addition,text
2.1365948000000117,40,8,48,48,Nov-13-2021,True,95.43496266061291,addition,text
3.86886530000001,16,25,41,41,Nov-13-2021,True,85.03188129045583,addition,text
2.2650283000000115,21,5,26,26,Nov-13-2021,True,94.86964680019906,addition,text
7.366614299999981,43,28,71,71,Nov-13-2021,True,45.73299375503579,addition,text
6.2574386,28,31,59,59,Nov-13-2021,True,60.844462167230034,addition,text
4.821636500000011,34,21,55,55,Nov-13-2021,True,76.75182146186765,addition,text
2.9597274000000198,39,30,69,69,Nov-13-2021,True,91.24001371768912,addition,text
3.403998300000012,34,50,84,74,Nov-13-2021,False,0.0,addition,text
5.542627199999998,38,23,61,61,Nov-13-2021,True,69.27928372182018,addition,text
3.6712401000000057,43,36,79,79,Nov-13-2021,True,86.52199612815195,addition,text
4.010680100000002,25,29,54,54,Nov-13-2021,True,83.91444513546398,addition,text
3.3307780000000093,48,11,59,59,Nov-13-2021,True,88.90591791471594,addition,text
5.284076499999998,12,26,38,38,Nov-13-2021,True,72.07853554214778,addition,text
4.372764700000005,44,25,69,69,Nov-13-2021,True,80.87892887843387,addition,text
3.277669199999991,12,33,45,45,Nov-13-2021,True,89.25688461537142,addition,text
3.7118930999999975,46,44,90,90,Nov-13-2021,True,86.22184961417241,addition,text
4.561704300000002,28,13,41,41,Nov-13-2021,True,79.19085387936148,addition,text
5.218592099999999,26,48,74,74,Nov-22-2021,True,72.7662964938176,addition,text
4.437557099999999,11,39,50,50,Nov-22-2021,True,80.3080869842396,addition,text
4.128178600000002,24,29,53,53,Nov-22-2021,True,82.95814144650203,addition,text
3.3841167999999975,28,46,74,74,Nov-22-2021,True,88.54775348395778,addition,text
5.111455899999996,31,27,58,58,Nov-22-2021,True,73.87301858235523,addition,text
5.575802400000001,49,27,76,76,Nov-22-2021,True,68.91042759615424,addition,text
3.0717478999999983,37,33,70,70,Nov-22-2021,True,90.5643648388456,addition,text
3.839107900000002,38,5,43,43,Nov-22-2021,True,85.26125053215758,addition,text
2.471776999999996,41,8,49,49,Nov-22-2021,True,93.89031846227103,addition,text
2.7914296000000007,6,47,53,53,Nov-22-2021,True,92.20792078824384,addition,text
2.871841400000001,35,40,75,75,Nov-22-2021,True,91.75252697324603,addition,text
3.208080499999994,41,21,62,62,Nov-22-2021,True,89.70821950551979,addition,text
8.976455799999997,46,37,83,83,Nov-22-2021,True,19.42324127064643,addition,text
5.160756400000011,8,25,33,33,Nov-22-2021,True,73.36659337985893,addition,text
3.0065421000000043,25,26,51,51,Nov-22-2021,True,90.96070460092756,addition,text
2.759218599999997,30,36,66,66,Nov-22-2021,True,92.38671271741406,addition,text
7.871882900000003,39,35,74,74,Nov-22-2021,True,38.033459608687544,addition,text
4.152019800000005,42,29,71,51,Nov-22-2021,False,0.0,addition,text
6.783149399999999,44,19,63,63,Nov-22-2021,True,53.98888421727965,addition,text
4.559996999999996,39,41,80,80,Nov-22-2021,True,79.20642735999104,addition,text
8.05750669999999,27,15,42,42,Nov-22-2021,True,35.07658577945526,addition,text
2.935825699999995,7,35,42,42,Nov-22-2021,True,91.38092745921954,addition,text
2.5034973000000065,15,9,24,24,Nov-22-2021,True,93.73250126889268,addition,text
8.318025399999996,27,17,44,44,Nov-22-2021,True,30.810453444954902,addition,text
2.5598838999999884,37,30,67,67,Nov-22-2021,True,93.44699441852084,addition,text
4.4795276000000115,8,37,45,45,Nov-22-2021,True,79.93383248083813,addition,text
4.999697999999995,5,33,38,38,Nov-22-2021,True,75.00301990879605,addition,text
4.7054515000000094,27,37,64,64,Nov-22-2021,True,77.85872618114766,addition,text
2.7357278000000065,30,26,56,56,Nov-22-2021,True,92.51579340430712,addition,text
6.8716273,12,21,33,33,Nov-22-2021,True,52.78073824989471,addition,text
4.908022800000001,41,39,80,80,Nov-19-2021,True,75.91131219468015,addition,text
3.0335807000000017,46,44,90,90,Nov-19-2021,True,90.7973881365875,addition,text
3.059823899999998,13,16,29,29,Dec-23-2021,True,90.6374777009888,addition,text
3.3796836,11,42,53,53,Dec-23-2021,True,88.57773876389103,addition,text
2.9775354000000007,45,14,59,59,Dec-23-2021,True,91.13428294174683,addition,text
3.616503399999999,40,35,75,75,Dec-23-2021,True,86.92090315778844,addition,text
2.8303234000000046,40,15,55,55,Dec-23-2021,True,91.98926945141241,addition,text
3.150232399999993,14,12,26,26,Dec-23-2021,True,90.07603582599029,addition,text
1.7875435999999922,8,6,14,14,Dec-23-2021,True,96.80468787809907,addition,text
4.055788200000009,35,26,61,61,Dec-23-2021,True,83.55058207674068,addition,text
3.0352240999999935,26,30,56,56,Dec-23-2021,True,90.78741466277923,addition,text
3.144918500000003,32,33,65,65,Dec-23-2021,True,90.10948762835773,addition,text
5.707823300000001,24,13,37,37,Dec-23-2021,True,67.4207531759771,addition,text
3.0556676000000067,41,21,62,62,Dec-23-2021,True,90.6628955183102,addition,text
3.0766057000000018,12,39,51,51,Dec-23-2021,True,90.53449736672749,addition,text
2.8836452000000037,7,49,56,56,Dec-23-2021,True,91.68459036051694,addition,text
4.645437100000009,39,41,80,80,Dec-23-2021,True,78.41991414994351,addition,text
2.9538669000000084,42,25,67,67,Dec-23-2021,True,91.27467033708434,addition,text
5.9536058999999995,19,36,55,55,Dec-23-2021,True,64.55457678748519,addition,text
3.1278923999999932,15,16,31,31,Dec-23-2021,True,90.21628913402228,addition,text
2.194993000000011,6,35,41,41,Dec-23-2021,True,95.18200572995096,addition,text
3.4523328000000078,39,31,70,70,Dec-23-2021,True,88.0813982380441,addition,text
2.494669000000002,40,34,74,74,Dec-23-2021,True,93.77662658043899,addition,text
2.430931700000002,40,22,62,62,Dec-23-2021,True,94.0905710699351,addition,text
3.728506100000004,13,47,60,60,Dec-23-2021,True,86.09824226226276,addition,text
3.9505096999999836,8,26,34,34,Dec-23-2021,True,84.39347311020605,addition,text
4.561125199999992,13,26,39,39,Dec-23-2021,True,79.19613690992503,addition,text
3.2415239000000042,26,7,33,33,Dec-23-2021,True,89.49252280572877,addition,text
8.072851100000008,27,35,62,62,Dec-23-2021,True,34.829075117228655,addition,text
2.7286325999999974,18,18,36,36,Dec-23-2021,True,92.55456413421726,addition,text
3.9054723999999794,17,27,44,44,Dec-23-2021,True,84.7472853328384,addition,text
5.834184800000003,6,28,34,34,Dec-23-2021,True,65.96228771944894,addition,text
2.3642618000000084,30,42,72,72,Dec-23-2021,True,94.41026614106072,addition,text
3.0627754999999866,33,17,50,50,Dec-23-2021,True,90.61940623659983,addition,text
5.4788006,38,15,53,53,Dec-23-2021,True,69.98274398543964,addition,text
4.287543199999988,11,45,56,56,Dec-23-2021,True,81.61697330813386,addition,text
7.21348900000001,29,45,74,74,Dec-23-2021,True,47.965576446878856,addition,text
3.599801499999984,48,26,74,74,Dec-23-2021,True,87.04142916059787,addition,text
3.5723541000000125,37,17,54,54,Dec-23-2021,True,87.2382861842131,addition,text
5.883533,46,24,70,70,Dec-23-2021,True,65.384039437911,addition,text
3.1858205999999996,49,41,90,90,Dec-23-2021,True,89.85054710461564,addition,text
3.7115365000000224,25,20,45,45,Dec-23-2021,True,86.22449680916759,addition,text
2.448506699999996,46,10,56,56,Dec-23-2021,True,94.00481494005513,addition,text
1.570100100000019,18,18,36,36,Dec-23-2021,True,97.53478567597993,addition,text
4.657471600000008,34,12,46,46,Dec-23-2021,True,78.30795829519337,addition,text
4.115562400000016,27,14,41,41,Dec-23-2021,True,83.0621461317061,addition,text
2.029963699999996,40,42,82,82,Dec-23-2021,True,95.87924737668233,addition,text
3.7781584999999893,45,23,68,68,Dec-23-2021,True,85.72551834887783,addition,text
2.5466675000000123,8,33,41,41,Dec-23-2021,True,93.51448464444368,addition,text
3.698730299999994,43,15,58,58,Dec-23-2021,True,86.31939416786196,addition,text
3.8507241999999735,47,30,77,77,Dec-23-2021,True,85.17192313553457,addition,text
3.8663760999999965,24,42,66,66,Dec-23-2021,True,85.05113585334881,addition,text
3.391212099999999,32,12,44,44,Dec-25-2021,True,88.4996804928136,addition,text
4.559898100000002,23,19,42,42,Dec-25-2021,True,79.20732931761637,addition,text
4.7059183,23,22,45,45,Dec-25-2021,True,77.8543329537251,addition,text
4.068242600000001,24,37,61,61,Dec-25-2021,True,83.44940214754523,addition,text
4.745905500000003,42,34,76,76,Dec-25-2021,True,77.47638098506972,addition,text
3.101880300000005,25,23,48,48,Dec-25-2021,True,90.37833860447188,addition,text
3.4817003,38,46,84,84,Dec-25-2021,True,87.87776302097991,addition,text
2.132497200000003,36,6,42,42,Dec-25-2021,True,95.45245569199214,addition,text
2.617997899999999,20,39,59,59,Dec-25-2021,True,93.1460869955956,addition,text
2.010561199999998,42,8,50,50,Dec-25-2021,True,95.95764366105456,addition,text
2.017620200000003,45,15,60,60,Dec-25-2021,True,95.92920872855194,addition,text
4.435626499999998,39,48,87,87,Dec-25-2021,True,80.32521755249778,addition,text
8.677862399999995,49,28,77,77,Dec-25-2021,True,24.694704166666327,addition,text
4.758626199999995,26,15,41,41,Dec-25-2021,True,77.3554766886736,addition,text
2.9520088000000015,37,5,42,42,Dec-25-2021,True,91.28564404472255,addition,text
3.0190429000000023,27,23,50,50,Dec-25-2021,True,90.88537996795958,addition,text
3.409637499999988,13,23,36,36,Dec-25-2021,True,88.37437211859383,addition,text
2.0584190999999947,11,40,51,51,Dec-25-2021,True,95.76291080875521,addition,text
3.33482699999999,28,5,33,33,Dec-25-2021,True,88.87892888007107,addition,text
2.6896950000000004,22,14,36,36,Dec-25-2021,True,92.765540806975,addition,text
1.6686590999999993,40,9,49,49,Dec-25-2021,True,97.21557680798719,addition,text
2.99759490000001,29,40,69,69,Dec-25-2021,True,91.01442481549392,addition,text
3.5129500000000036,28,38,66,66,Dec-25-2021,True,87.65918229749997,addition,text
1.8601151999999956,50,7,57,57,Dec-25-2021,True,96.53997144272897,addition,text
2.1629060000000067,44,50,94,94,Dec-25-2021,True,95.32183763516397,addition,text
2.863833999999997,48,41,89,89,Dec-25-2021,True,91.79845482044402,addition,text
3.6637157999999914,14,9,23,23,Dec-25-2021,True,86.57718653683042,addition,text
3.195515599999993,38,12,50,50,Dec-25-2021,True,89.78868005015669,addition,text
2.305496699999992,20,34,54,54,Dec-25-2021,True,94.68468496628915,addition,text
5.508693699999995,7,48,55,55,Dec-25-2021,True,69.65429371958037,addition,text
4.192372300000002,17,31,48,48,Dec-25-2021,True,82.42401449819269,addition,text
3.386058300000002,33,25,58,58,Dec-25-2021,True,88.5346091890011,addition,text
2.206969100000009,20,14,34,34,Dec-25-2021,True,95.12928739164515,addition,text
1.7700828000000115,10,47,57,57,Dec-25-2021,True,96.86680688114411,addition,text
2.0294177000000104,30,34,64,64,Dec-25-2021,True,95.88146379892667,addition,text
7.294287500000024,27,36,63,63,Dec-25-2021,True,46.793369867343394,addition,text
3.3673293999999885,14,25,39,39,Dec-25-2021,True,88.66109271189572,addition,text
2.1076447000000087,40,15,55,55,Dec-25-2021,True,95.55783381856187,addition,text
2.679376899999994,32,31,63,63,Dec-25-2021,True,92.82093942774642,addition,text
2.8124651999999912,23,36,59,59,Dec-25-2021,True,92.09003949878901,addition,text
7.577929100000006,28,45,73,73,Dec-25-2021,True,42.574990555373105,addition,text
2.606969399999997,34,10,44,54,Dec-25-2021,False,0.0,addition,text
3.756328300000007,35,19,54,54,Dec-25-2021,True,85.88999770261906,addition,text
3.888738599999982,44,29,73,73,Dec-25-2021,True,84.87771210087018,addition,text
2.051404400000024,20,44,64,64,Dec-25-2021,True,95.79173998766055,addition,text
2.218920799999978,10,20,30,30,Dec-25-2021,True,95.07639048332746,addition,text
2.1117312000000084,15,50,65,65,Dec-25-2021,True,95.54059133894653,addition,text
2.4271223000000077,34,34,68,68,Dec-25-2021,True,94.10907734084267,addition,text
3.3494447000000207,31,23,54,54,Dec-25-2021,True,88.78122020164177,addition,text
3.8509573000000046,41,34,75,75,Dec-25-2021,True,85.17012787357667,addition,text
4.032736,28,14,42,42,Dec-30-2021,True,83.737040354304,addition,text
2.4904322000000008,6,14,20,20,Dec-30-2021,True,93.79774745720316,addition,text
7.746263099999993,42,35,77,77,Dec-30-2021,True,39.995407985578495,addition,text
2.0181500999999997,12,6,18,18,Dec-30-2021,True,95.92707017386999,addition,text
1.5544067999999953,10,8,18,18,Dec-30-2021,True,97.58381950011378,addition,text
1.6188961000000006,16,16,32,32,Dec-30-2021,True,97.37917541740478,addition,text
8.583952199999999,28,35,63,63,Dec-30-2021,True,26.315764628115176,addition,text
3.277736900000008,32,42,74,74,Dec-30-2021,True,89.25644081437834,addition,text
3.611124100000012,46,21,67,67,Dec-30-2021,True,86.9597827343991,addition,text
2.7984830000000045,43,20,63,63,Dec-30-2021,True,92.16849289871098,addition,text
2.7601839999999953,12,14,26,26,Dec-30-2021,True,92.38138428614403,addition,text
2.991431399999996,24,41,65,65,Dec-30-2021,True,91.05133817909406,addition,text
3.4128900999999985,30,14,44,44,Dec-30-2021,True,88.352181165322,addition,text
3.9332009000000028,33,18,51,51,Dec-30-2021,True,84.52993068023918,addition,text
2.6471930000000015,8,18,26,26,Dec-30-2021,True,92.99236922075099,addition,text
5.791207299999996,39,48,87,87,Dec-30-2021,True,66.46191800842675,addition,text
2.339977899999994,36,5,41,41,Dec-30-2021,True,94.52450342751162,addition,text
1.848966500000003,18,18,36,36,Dec-30-2021,True,96.58132288187774,addition,text
1.5232529000000028,6,10,16,16,Dec-30-2021,True,97.67970060264159,addition,text
2.134227199999998,10,34,44,44,Dec-30-2021,True,95.44507425878017,addition,text
7.933000000000007,43,22,65,65,Dec-30-2021,True,37.06751099999989,addition,text
3.955654100000004,14,28,42,42,Dec-30-2021,True,84.35280064115315,addition,text
3.3223350000000096,14,46,60,60,Dec-30-2021,True,88.96209014777494,addition,text
3.297302299999984,22,9,31,31,Dec-30-2021,True,89.12779754241481,addition,text
1.572550399999983,50,10,60,60,Dec-30-2021,True,97.5270852394599,addition,text
2.7849979000000076,38,20,58,58,Dec-30-2021,True,92.24378669699554,addition,text
4.280444799999998,28,27,55,55,Dec-30-2021,True,81.67779231415298,addition,text
5.133685800000023,32,17,49,49,Dec-30-2021,True,73.64527010687812,addition,text
4.044015900000005,12,49,61,61,Dec-30-2021,True,83.64593540054715,addition,text
2.4447445999999786,17,7,24,24,Dec-30-2021,True,94.02322384077094,addition,text
7.679334800000021,33,14,47,47,Dec-30-2021,True,41.02781702950864,addition,text
3.920151799999985,7,46,53,53,Dec-30-2021,True,84.63240986495688,addition,text
4.017249600000014,28,50,78,78,Dec-30-2021,True,83.86170565129973,addition,text
2.554539500000004,41,5,46,46,Dec-30-2021,True,93.47432794293972,addition,text
2.675031199999978,39,8,47,47,Dec-30-2021,True,92.84420807902667,addition,text
4.616763300000002,17,18,35,35,Dec-30-2021,True,78.68549663177309,addition,text
4.045760800000011,15,19,34,34,Dec-30-2021,True,83.63181954918328,addition,text
3.8431281000000013,33,19,52,52,Dec-30-2021,True,85.23036640699038,addition,text
3.785656199999977,18,28,46,46,Dec-30-2021,True,85.66880713540174,addition,text
4.396035500000011,18,50,68,68,Dec-30-2021,True,80.67487188273965,addition,text
4.2417686,38,22,60,60,Dec-30-2021,True,82.00739914405403,addition,text
4.990004499999998,18,27,45,45,Dec-30-2021,True,75.09985508997977,addition,text
2.7850793000000067,23,6,29,29,Dec-30-2021,True,92.24333329271147,addition,text
2.282045300000007,5,41,46,46,Dec-31-2021,True,94.79226924874787,addition,text
2.344683500000002,46,12,58,58,Dec-31-2021,True,94.50245928482774,addition,text
4.155875699999996,15,8,23,23,Dec-31-2021,True,82.72869716614954,addition,text
2.0445122,10,12,22,22,Dec-31-2021,True,95.81996986405116,addition,text
3.5229062000000084,33,28,61,61,Dec-31-2021,True,87.5891319060015,addition,text
2.280481899999998,40,34,74,74,Dec-31-2021,True,94.7994023037724,addition,text
5.7390094000000005,27,16,43,43,Dec-31-2021,True,67.06377110671164,addition,text
2.7035120000000035,38,20,58,58,Dec-31-2021,True,92.69102286585598,addition,text
2.426867400000006,38,8,46,46,Dec-31-2021,True,94.11031462281721,addition,text
3.3453797000000094,5,27,32,32,Dec-31-2021,True,88.80843466282785,addition,text
5.642039600000004,19,28,47,47,Dec-31-2021,True,68.1673891520318,addition,text
3.2485321999999996,18,28,46,46,Dec-31-2021,True,89.44703854556316,addition,text
2.5098317000000065,50,44,94,94,Dec-31-2021,True,93.70074483767507,addition,text
3.241492199999996,32,34,66,66,Dec-31-2021,True,89.49272831733919,addition,text
4.77376910000001,44,18,62,62,Dec-31-2021,True,77.2111285798851,addition,text
5.398581800000002,30,16,46,46,Dec-31-2021,True,70.85531454870873,addition,text
2.1049117000000024,40,50,90,90,Dec-31-2021,True,95.5693467352031,addition,text
3.7377025999999915,29,16,45,45,Dec-31-2021,True,86.0295792739533,addition,text
3.784836399999989,12,33,45,45,Dec-31-2021,True,85.67501342523512,addition,text
2.6126653000000033,40,28,68,68,Dec-31-2021,True,93.1739800301759,addition,text
6.013438600000001,27,34,61,61,Dec-31-2021,True,63.838556204030034,addition,text
3.146450699999974,46,26,72,72,Dec-31-2021,True,90.09984799246968,addition,text
3.5104862000000026,50,34,84,74,Dec-31-2021,False,0.0,addition,text
3.3961625999999967,10,28,38,387,Dec-31-2021,False,0.0,addition,text
4.085695499999986,20,31,51,51,Dec-31-2021,True,83.30709228127986,addition,text
5.420973599999996,32,50,82,82,Dec-31-2021,True,70.61304522810308,addition,text
5.849439499999988,19,45,64,64,Dec-31-2021,True,65.78405753583988,addition,text
3.486449300000004,37,6,43,43,Dec-31-2021,True,87.84467127852949,addition,text
4.272030999999998,18,24,42,42,Dec-31-2021,True,81.74975113503902,addition,text
6.69965289999999,28,39,67,67,Dec-31-2021,True,55.11465101952173,addition,text
2.237128100000003,13,40,53,53,Jan-01-2022,True,94.99525786419038,addition,text
3.4059857999999963,48,17,65,65,Jan-01-2022,True,88.39926073019839,addition,text
2.7929665999999997,28,25,53,53,Jan-01-2022,True,92.19933757128445,addition,text
3.1952187999999992,41,24,65,65,Jan-01-2022,True,89.79057682012656,addition,text
2.2501359000000036,12,10,22,22,Jan-01-2022,True,94.93688843153117,addition,text
1.550758799999997,7,40,47,47,Jan-01-2022,True,97.59514714422257,addition,text
2.299621699999996,41,30,71,71,Jan-01-2022,True,94.71174003688913,addition,text
4.374743699999996,13,39,52,52,Jan-01-2022,True,80.86161755931035,addition,text
2.1683471999999995,10,32,42,42,Jan-01-2022,True,95.29827042025217,addition,text
3.0370801000000043,41,33,74,74,Jan-01-2022,True,90.77614446618396,addition,text
4.0683137999999985,27,43,70,70,Jan-01-2022,True,83.44882282472958,addition,text
4.0844609999999975,42,36,78,78,Jan-01-2022,True,83.31717833947903,addition,text
4.95104400000001,12,24,36,36,Jan-01-2022,True,75.48716331006389,addition,text
3.619631499999997,36,42,78,78,Jan-01-2022,True,86.89826780420778,addition,text
5.871783800000003,43,24,67,67,Jan-01-2022,True,65.52215500605752,addition,text
4.347367699999992,34,37,71,71,Jan-01-2022,True,81.10039408099678,addition,text
2.7515199999999993,7,29,36,36,Jan-01-2022,True,92.4291376896,addition,text
6.3409189999999995,35,13,48,48,Jan-01-2022,True,59.792746235439004,addition,text
6.095361499999996,34,28,62,62,Jan-01-2022,True,62.8465681843178,addition,text
3.548821799999999,17,18,35,35,Jan-01-2022,True,87.40586383184477,addition,text
5.200564100000008,12,18,30,30,Jan-01-2022,True,72.9541330417911,addition,text
4.281012199999992,37,45,82,82,Jan-01-2022,True,81.67293454345122,addition,text
4.042485499999998,48,44,92,92,Jan-01-2022,True,83.65831098228976,addition,text
2.7305497000000116,6,49,55,55,Jan-01-2022,True,92.54409833582984,addition,text
2.687687000000011,49,7,56,56,Jan-01-2022,True,92.77633859003095,addition,text
3.5310343000000017,32,9,41,41,Jan-01-2022,True,87.5317967722235,addition,text
2.9477159000000057,48,32,80,80,Jan-01-2022,True,91.31097097288716,addition,text
3.251058999999998,47,47,94,94,Jan-01-2022,True,89.43061537851901,addition,text
6.051762300000007,25,46,71,71,Jan-01-2022,True,63.37617306429863,addition,text
6.776834699999995,29,40,69,69,Jan-01-2022,True,54.07451144887598,addition,text
3.095150600000011,9,19,28,28,Jan-01-2022,True,90.42004276331957,addition,text
4.107722499999994,37,25,62,62,Jan-01-2022,True,83.1266158629938,addition,text
1.850076300000012,12,12,24,24,Jan-01-2022,True,96.57721768417827,addition,text
4.332655299999999,26,24,50,50,Jan-01-2022,True,81.22809805138192,addition,text
1.9039471000000106,40,5,45,45,Jan-01-2022,True,96.37498544040155,addition,text
2.6673446999999726,16,6,22,24,Jan-01-2022,False,35.967450262438504,addition,text
5.769820199999998,12,13,25,25,Jan-01-2022,True,66.70917485967198,addition,text
2.011087900000007,30,35,65,65,Jan-01-2022,True,95.95552545847356,addition,text
5.700479900000005,37,29,66,66,Jan-01-2022,True,67.50452890969594,addition,text
7.623119700000018,6,28,34,34,Jan-01-2022,True,41.88804603947164,addition,text
6.499895000000009,42,19,61,61,Jan-01-2022,True,57.75136498897488,addition,text
3.604668900000007,34,44,78,78,Jan-01-2022,True,87.00636212137275,addition,text
2.3158765000000017,35,30,65,65,Jan-01-2022,True,94.63671603674774,addition,text
4.320351200000005,29,17,46,46,Jan-01-2022,True,81.33456550865853,addition,text
3.5700630999999987,19,11,30,30,Jan-01-2022,True,87.25464946201839,addition,text
4.011372900000026,32,5,37,37,Jan-01-2022,True,83.90888745714538,addition,text
5.679697400000009,21,11,32,32,Jan-01-2022,True,67.74103744443315,addition,text
3.7988719999999887,17,40,57,57,Jan-01-2022,True,85.56857152761609,addition,text
4.04473969999998,11,26,37,37,Jan-01-2022,True,83.64008075924407,addition,text
4.613665300000008,14,22,36,36,Jan-01-2022,True,78.71409249957583,addition,text
3.243860699999999,40,26,66,66,Jan-01-2022,True,89.47736775899551,addition,text
2.2727812000000007,40,49,89,89,Jan-02-2022,True,94.83446561692655,addition,text
4.608718500000002,35,48,83,83,Jan-02-2022,True,78.75971378775773,addition,text
2.3979025000000007,30,12,42,42,Jan-02-2022,True,94.25006360049375,addition,text
3.1827992000000016,28,33,61,61,Jan-02-2022,True,89.86978925247935,addition,text
2.387308400000002,34,10,44,44,Jan-02-2022,True,94.30075860328942,addition,text
1.565885999999999,10,20,30,30,Jan-02-2022,True,97.548001035004,addition,text
2.3917836999999977,15,50,65,65,Jan-02-2022,True,94.27937073241432,addition,text
3.1885023000000032,44,38,82,82,Jan-02-2022,True,89.83345308289469,addition,text
2.8554894000000033,48,41,89,89,Jan-02-2022,True,91.84618028648762,addition,text
3.523503499999997,35,26,61,71,Jan-02-2022,False,0.0,addition,text
5.756869000000002,45,23,68,78,Jan-02-2022,False,0.0,addition,text
7.916820099999995,41,13,54,54,Jan-02-2022,True,37.323959504236065,addition,text
5.0373321000000075,45,35,80,80,Jan-02-2022,True,74.62528531430951,addition,text
3.541773599999999,22,20,42,42,Jan-02-2022,True,87.45583976634305,addition,text
2.357632499999994,19,19,38,38,Jan-02-2022,True,94.44156899494378,addition,text
3.573863099999997,26,29,55,55,Jan-02-2022,True,87.22750254245841,addition,text
2.5325538000000023,20,48,68,68,Jan-02-2022,True,93.58617125010555,addition,text
3.599563599999996,29,27,56,56,Jan-02-2022,True,87.04314188955507,addition,text
3.8159538000000026,41,45,86,86,Jan-02-2022,True,85.43849659626554,addition,text
2.2646117000000032,32,20,52,52,Jan-02-2022,True,94.8715338482231,addition,text
1.5613876000000033,30,6,36,36,Jan-02-2022,True,97.56206876256623,addition,text
2.8839576000000022,16,31,47,47,Jan-02-2022,True,91.68278856140222,addition,text
3.2936473000000035,41,35,76,76,Jan-02-2022,True,89.15188746320268,addition,text
3.378902400000001,27,41,68,68,Jan-02-2022,True,88.58301857127424,addition,text
2.4763488999999907,39,10,49,49,Jan-02-2022,True,93.86769612546884,addition,text
2.3430845999999974,44,9,53,53,Jan-02-2022,True,94.50995455724285,addition,text
2.9137362000000024,13,24,37,37,Jan-02-2022,True,91.51014135680954,addition,text
2.978512100000003,11,26,37,37,Jan-02-2022,True,91.12846567015357,addition,text
4.125607400000007,18,21,39,39,Jan-02-2022,True,82.97936358106519,addition,text
3.6627881,28,21,49,49,Jan-02-2022,True,86.58398333449838,addition,text
3.132876500000009,22,16,38,38,Jan-02-2022,True,90.18508483574769,addition,text
3.4763248999999945,33,15,48,48,Jan-02-2022,True,87.91516518964002,addition,text
2.025390299999998,30,20,50,50,Jan-02-2022,True,95.89779413266592,addition,text
3.843115999999995,25,13,38,38,Jan-02-2022,True,85.23045941054404,addition,text
3.648810400000002,41,35,76,76,Jan-02-2022,True,86.68618266485183,addition,text
2.062558899999999,8,20,28,28,Jan-02-2022,True,95.7458507840308,addition,text
4.109807399999994,46,45,91,91,Jan-02-2022,True,83.10948313490529,addition,text
4.966907499999991,8,36,44,44,Jan-02-2022,True,75.32982988644385,addition,text
3.1666256999999973,12,21,33,33,Jan-02-2022,True,89.97248167609953,addition,text
2.941545500000018,12,23,35,33,Jan-02-2022,False,22.125790642866804,addition,text
5.212589999999977,47,12,59,59,Jan-02-2022,True,72.82890549190023,addition,text
3.8178714999999954,21,49,70,70,Jan-02-2022,True,85.42385720948778,addition,text
2.759868900000015,20,14,34,34,Jan-02-2022,True,92.3831236548127,addition,text
3.904512699999998,31,28,59,59,Jan-02-2022,True,84.75478057553873,addition,text
2.345256899999981,18,8,26,26,Jan-02-2022,True,94.49977007300248,addition,text
2.810062700000003,45,43,88,88,Jan-02-2022,True,92.10354762206869,addition,text
6.920643500000011,28,27,55,55,Jan-02-2022,True,52.104693545907594,addition,text
3.1943172999999945,41,37,78,78,Jan-02-2022,True,89.79633698692075,addition,text
3.7874083999999755,35,32,67,67,Jan-02-2022,True,85.65553761160963,addition,text
2.9693009000000075,41,27,68,68,Jan-02-2022,True,91.18325216525915,addition,text
3.705893799999984,33,28,61,61,Jan-02-2022,True,86.26635114312168,addition,text
3.285484800000006,46,44,90,90,Jan-02-2022,True,89.20558962896892,addition,text
5.189025700000002,47,48,95,95,Jan-02-2022,True,73.0740122847395,addition,text
3.4094843999999966,15,14,29,29,Jan-02-2022,True,88.37541612615667,addition,text
3.5297151999999983,15,33,48,48,Jan-02-2022,True,87.54111060688898,addition,text
3.325986999999998,7,17,24,24,Jan-02-2022,True,88.93781047583101,addition,text
12.349588499999982,18,24,42,42,Jan-02-2022,True,0.0,addition,text
5.866898499999991,26,14,40,40,Jan-02-2022,True,65.57950199069785,addition,text
3.5795233,48,33,81,81,Jan-15-2022,True,87.18701294475711,addition,text
7.4098184000000025,38,19,57,57,Jan-15-2022,True,45.0945912790214,addition,text
4.5778295,24,26,50,50,Jan-15-2022,True,79.04347706892975,addition,text
4.356587400000002,29,36,65,65,Jan-15-2022,True,81.02014622616122,addition,text
2.6497265,6,21,27,27,Jan-15-2022,True,92.97894947519775,addition,text
2.482553799999998,19,11,30,30,Jan-15-2022,True,93.83692663010557,addition,text
3.3755212999999955,19,42,61,61,Jan-15-2022,True,88.60585595324633,addition,text
3.256874500000002,21,11,32,32,Jan-15-2022,True,89.39276849124974,addition,text
3.926575999999997,7,15,22,22,Jan-15-2022,True,84.58200091622402,addition,text
2.345927499999995,45,50,95,95,Jan-15-2022,True,94.49662416474378,addition,text
1.983749000000003,14,16,30,30,Jan-15-2022,True,96.06473990499899,addition,text
7.217582300000004,39,21,60,60,Jan-15-2022,True,47.90650574272666,addition,text
3.005875500000002,5,43,48,48,Jan-15-2022,True,90.96471247849973,addition,text
3.6495723999999967,33,13,46,46,Jan-15-2022,True,86.68062129715827,addition,text
2.0018514000000067,15,15,30,30,Jan-15-2022,True,95.99259097231801,addition,text
2.3575491,16,9,25,25,Jan-16-2022,True,94.44196224108919,addition,text
4.298498499999994,39,14,53,53,Jan-16-2022,True,81.5229106454978,addition,text
1.9625561999999945,40,9,49,49,Jan-16-2022,True,96.14837316184158,addition,text
4.844963100000001,12,32,44,44,Jan-16-2022,True,76.52633255963838,addition,text
5.041598699999994,48,46,94,94,Jan-16-2022,True,74.58228254815836,addition,text
4.010060100000004,9,49,58,58,Jan-16-2022,True,83.91941799438796,addition,text
5.127504799999997,48,46,94,94,Jan-16-2022,True,73.708694525977,addition,text
2.513064,13,8,21,21,Feb-03-2022,True,93.684509331904,addition,text
2.9854079999999996,13,36,49,49,Feb-03-2022,True,91.087339073536,addition,text
2.5802321999999975,32,20,52,52,Feb-03-2022,True,93.34240179408317,addition,text
5.0434351000000035,45,25,70,70,Feb-03-2022,True,74.56376239208795,addition,text
2.474095399999996,25,20,45,45,Feb-03-2022,True,93.87885195169886,addition,text
2.818599800000001,14,46,60,60,Feb-03-2022,True,92.05549516743996,addition,text
3.9477024999999983,41,38,79,79,Feb-03-2022,True,84.41564497149376,addition,text
2.1596867000000017,6,18,24,24,Feb-03-2022,True,95.3357533578431,addition,text
2.5344076000000015,49,40,89,89,Feb-03-2022,True,93.57677811706223,addition,text
4.447335299999999,47,21,68,68,Feb-03-2022,True,80.22120872937393,addition,text
3.098674899999999,31,7,38,38,Feb-03-2022,True,90.39821386410999,addition,text
3.142319899999997,14,12,26,26,Feb-03-2022,True,90.12582564606402,addition,text
6.446086300000005,46,17,63,63,Feb-03-2022,True,58.44797141295225,addition,text
4.760572699999997,8,35,43,43,Feb-03-2022,True,77.33694756801474,addition,text
4.736114299999997,49,29,78,78,Feb-03-2022,True,77.56922133733553,addition,text
3.4318674999999956,46,47,93,93,Feb-03-2022,True,88.22228546244378,addition,text
3.878711999999993,37,9,46,46,Feb-03-2022,True,84.95559322105605,addition,text
3.302663299999992,34,12,46,46,Feb-03-2022,True,89.09241512683316,addition,text
2.1983345999999955,36,36,72,72,Feb-03-2022,True,95.16732498644286,addition,text
2.3071477000000016,6,34,40,40,Feb-03-2022,True,94.6770694903847,addition,text
3.0634858000000094,50,27,77,77,Feb-03-2022,True,90.61505475319831,addition,text
3.126819900000001,33,21,54,54,Feb-03-2022,True,90.22299731296398,addition,text
2.008917800000006,8,20,28,28,Feb-03-2022,True,95.96424927284313,addition,text
2.757316099999997,31,26,57,57,Feb-03-2022,True,92.3972079246808,addition,text
2.253372899999988,45,10,55,55,Feb-03-2022,True,94.92231057354564,addition,text
2.8649704999999983,33,32,65,65,Feb-03-2022,True,91.79194403412976,addition,text
5.487952500000006,42,19,61,61,Feb-03-2022,True,69.88237735774368,addition,text
3.2099436000000026,30,49,79,79,Feb-03-2022,True,89.69626208481903,addition,text
2.3356012999999933,9,15,24,24,Feb-03-2022,True,94.54496656743834,addition,text
2.6918812000000116,6,44,50,50,Feb-03-2022,True,92.7537756050865,addition,text
3.3436273999999884,46,33,79,79,Feb-03-2022,True,88.82015580996932,addition,text
3.8776007000000163,7,36,43,43,Feb-03-2022,True,84.96421281135939,addition,text
3.5235480999999993,23,17,40,40,Feb-03-2022,True,87.5846087869864,addition,text
1.749420999999984,40,6,46,46,Feb-03-2022,True,96.93952616475906,addition,text
3.2274176999999895,29,25,54,54,Feb-03-2022,True,89.58377498972678,addition,text
3.799722900000006,43,32,75,75,Feb-03-2022,True,85.56210588321554,addition,text
3.048500099999984,33,11,44,44,Feb-03-2022,True,90.70664714030009,addition,text
6.369877500000001,39,22,61,61,Feb-03-2022,True,59.424660634993735,addition,text
3.3602764999999977,29,20,49,49,Feb-03-2022,True,88.70854184354776,addition,text
2.3169996999999967,32,20,52,52,Feb-03-2022,True,94.63151239019993,addition,text
6.451432299999993,48,39,87,87,Feb-03-2022,True,58.379021278516795,addition,text
3.505075199999993,11,29,40,40,Feb-03-2022,True,87.71444784234501,addition,text
4.802809599999989,29,12,41,41,Feb-03-2022,True,76.93301994614794,addition,text
2.1696589000000017,5,22,27,27,Feb-03-2022,True,95.29258025765078,addition,text
2.7706704,37,37,74,74,Feb-03-2022,True,92.32338553456384,addition,text
9.038509500000004,34,18,52,52,Feb-03-2022,True,18.30534601840968,addition,text
2.974640000000001,42,30,72,72,Jan-23-2022,True,91.1515168704,addition,text
2.418502499999999,50,21,71,71,Jan-23-2022,True,94.15084565749376,addition,text
3.191256899999999,37,11,48,48,Jan-23-2022,True,89.8158793982024,addition,text
4.072182499999997,18,16,34,34,Jan-23-2022,True,83.41732968669378,addition,text
2.3554705999999968,21,9,30,30,Jan-23-2022,True,94.45175825253565,addition,text
2.6787583999999995,16,30,46,46,Jan-26-2022,True,92.82425343442944,addition,text
2.705771699999998,30,33,63,63,Jan-26-2022,True,92.67879950747913,addition,text
3.5767127999999992,45,13,58,58,Jan-26-2022,True,87.20712554631616,addition,text
3.0461574999999996,5,28,33,33,Jan-26-2022,True,90.72092448519375,addition,text
4.425702399999999,26,33,59,59,Jan-26-2022,True,80.41315826663426,addition,text
3.3415236999999998,33,6,39,39,Jan-26-2022,True,88.83421936233832,addition,text
3.1757697000000036,12,37,49,49,Jan-26-2022,True,89.91448681256189,addition,text
4.1361915000000025,25,36,61,61,Jan-26-2022,True,82.89191987532773,addition,text
1.9434790000000035,5,5,10,10,Jan-26-2022,True,96.22288937655898,addition,text
3.959026899999998,16,22,38,38,Jan-26-2022,True,84.32610600507641,addition,text
2.2083386999999988,46,10,56,56,Jan-26-2022,True,95.12324018608231,addition,text
3.064681399999998,20,25,45,45,Jan-26-2022,True,90.60772791649406,addition,text
4.006643799999999,26,24,50,50,Jan-26-2022,True,83.94680545992156,addition,text
2.826926500000006,46,11,57,57,Jan-26-2022,True,92.00848656359771,addition,text
3.652629300000001,49,46,95,95,Jan-26-2022,True,86.6582991967815,addition,text
2.2232582999999977,13,7,20,20,Jan-26-2022,True,95.05712253148113,addition,text
1.9840423999999999,6,35,41,41,Jan-26-2022,True,96.06357575500223,addition,text
3.4794158999999993,10,45,55,55,Jan-26-2022,True,87.89366499482719,addition,text
2.086185299999997,39,7,46,46,Jan-26-2022,True,95.64783089406393,addition,text
1.8013972999999908,20,25,45,45,Jan-26-2022,True,96.75496776755274,addition,text
4.792185200000006,39,35,74,84,Jan-26-2022,False,0.0,addition,text
14.413621799999987,41,46,87,87,Jan-26-2022,True,0.0,addition,text
5.663151799999994,24,19,43,33,Jan-26-2022,False,0.0,addition,text
8.1302309,44,37,81,81,Jan-26-2022,True,33.89934551268517,addition,text
2.136533599999993,40,24,64,64,Jan-26-2022,True,95.43522417607107,addition,text
3.0543306,30,32,62,62,Jan-26-2022,True,90.67106458590364,addition,text
3.047997600000002,39,32,71,71,Jan-26-2022,True,90.70971063039423,addition,text
2.119121000000007,40,13,53,53,Jan-26-2022,True,95.50932618735897,addition,text
2.2875610999999907,22,6,28,28,Jan-26-2022,True,94.76706421376683,addition,text
3.1667459000000093,5,9,14,14,Jan-26-2022,True,89.97172040483314,addition,text
2.330180200000001,8,10,18,18,Jan-26-2022,True,94.57026023552795,addition,text
5.214097800000005,47,46,93,93,Jan-26-2022,True,72.8131841320351,addition,text
5.399526199999997,34,29,63,63,Jan-26-2022,True,70.84511681551359,addition,text
2.351972200000006,39,5,44,44,Jan-26-2022,True,94.46822677042714,addition,text
1.8106495999999765,20,21,41,41,Jan-26-2022,True,96.72154802601993,addition,text
1.6690176999999835,8,40,48,48,Jan-26-2022,True,97.21437991708676,addition,text
2.9674907000000132,19,33,52,52,Jan-26-2022,True,91.19399894541343,addition,text
3.109317400000009,50,36,86,86,Jan-26-2022,True,90.33214530605719,addition,text
4.329363999999998,15,41,56,56,Jan-26-2022,True,81.25660735550402,addition,text
2.2559090000000026,18,9,27,27,Jan-26-2022,True,94.91087458371899,addition,text
2.1579877000000067,37,20,57,57,Jan-26-2022,True,95.34308908664867,addition,text
3.466368899999992,5,43,48,48,Jan-26-2022,True,87.98428664911285,addition,text
3.1670996999999943,48,11,59,59,Jan-26-2022,True,89.96947949025994,addition,text
2.6235378000000082,12,18,30,30,Jan-26-2022,True,93.11704941197112,addition,text
4.527721499999984,39,9,48,48,Jan-26-2022,True,79.4997380184379,addition,text
8.088084199999997,48,45,93,93,Jan-26-2022,True,34.5828939737104,addition,text
3.888108999999986,19,32,51,51,Jan-26-2022,True,84.88260840411911,addition,text
3.974133500000022,24,46,70,70,Jan-26-2022,True,84.20626292417758,addition,text
4.176520799999992,15,46,61,61,Jan-26-2022,True,82.55667400716743,addition,text
5.271632299999993,28,45,73,63,Jan-26-2022,False,0.0,addition,text
4.007399000000021,18,20,38,38,Jan-26-2022,True,83.94075325479884,addition,text
4.938058099999999,31,28,59,59,Jan-27-2022,True,75.6155822010244,addition,text
3.1827521999999995,26,44,70,70,Jan-27-2022,True,89.87008843339517,addition,text
3.5571520999999997,44,14,58,58,Jan-27-2022,True,87.3466689374656,addition,text
4.785213200000001,15,43,58,58,Jan-27-2022,True,77.10173463054575,addition,text
3.3133500000000033,27,11,38,38,Jan-27-2022,True,89.02171177749997,addition,text
2.578984700000003,36,9,45,45,Jan-27-2022,True,93.3488379171659,addition,text
2.532230900000002,35,6,41,41,Jan-27-2022,True,93.58780666908518,addition,text
2.565797400000001,30,46,76,76,Jan-27-2022,True,93.41668370215324,addition,text
3.147785599999999,22,24,46,46,Jan-27-2022,True,90.09144581643265,addition,text
4.075669300000001,14,13,27,27,Jan-27-2022,True,83.3889197570375,addition,text
2.4920430999999965,5,37,42,42,Jan-27-2022,True,93.7897211877424,addition,text
2.797253099999999,15,25,40,40,Jan-27-2022,True,92.1753750945404,addition,text
3.3413942999999975,48,32,80,80,Jan-27-2022,True,88.83508413192753,addition,text
3.5487684,46,46,92,92,Jan-27-2022,True,87.40624284316144,addition,text
2.233689500000004,22,8,30,30,Jan-27-2022,True,95.01063121758973,addition,text
4.234499800000002,43,16,59,59,Jan-27-2022,True,82.06901144379995,addition,text
3.480696100000003,7,9,16,16,Jan-27-2022,True,87.88475465944477,addition,text
2.9167453000000023,48,22,70,70,Jan-27-2022,True,91.4925968549279,addition,text
1.985794299999995,14,6,20,20,Jan-27-2022,True,96.05662099808752,addition,text
3.653747299999992,23,44,67,67,Jan-27-2022,True,86.65013066774277,addition,text
4.765647900000005,37,12,49,49,Jan-27-2022,True,77.28860009322554,addition,text
2.624647699999997,24,12,36,36,Jan-27-2022,True,93.11122445088472,addition,text
2.1204211000000015,7,12,19,19,Jan-27-2022,True,95.50381435867479,addition,text
3.0701382999999964,44,24,68,68,Jan-27-2022,True,90.57425081887314,addition,text
5.512625799999995,35,29,64,64,Jan-27-2022,True,69.61095678917442,addition,text
4.00150330000001,36,23,59,59,Jan-27-2022,True,83.98797134008903,addition,text
6.032896800000003,50,38,88,88,Jan-27-2022,True,63.604156200549724,addition,text
4.821852600000014,41,26,67,67,Jan-27-2022,True,76.7497375038731,addition,text
3.848610999999991,11,25,36,36,Jan-27-2022,True,85.18819337067907,addition,text
5.915718600000005,16,27,43,43,Jan-27-2022,True,65.00427344561398,addition,text
4.234200700000002,44,47,91,91,Jan-27-2022,True,82.0715444321195,addition,text
2.6298639000000037,25,20,45,45,Jan-27-2022,True,93.08381586747677,addition,text
2.792803500000005,31,37,68,68,Jan-27-2022,True,92.20024861038772,addition,text
3.983805799999999,18,50,68,68,Jan-27-2022,True,84.12929134788637,addition,text
2.7254694000000086,23,21,44,44,Jan-27-2022,True,92.5718165496636,addition,text
3.4978399999999965,40,49,89,89,Jan-27-2022,True,87.76511533440002,addition,text
3.843539199999981,11,13,24,24,Jan-27-2022,True,85.2272064180635,addition,text
1.9352439000000174,5,41,46,46,Jan-27-2022,True,96.25483104751272,addition,text
2.9160453000000075,41,36,77,77,Jan-27-2022,True,91.49667980834786,addition,text
3.5510243999999886,6,47,53,53,Jan-27-2022,True,87.39022571060472,addition,text
3.554954699999996,50,27,77,77,Jan-27-2022,True,87.36229708094794,addition,text
2.6304874999999868,35,9,44,44,Jan-27-2022,True,93.08053551234381,addition,text
3.6652389999999855,30,17,47,47,Jan-27-2022,True,86.5660230728791,addition,text
2.7596949999999936,42,42,84,84,Jan-27-2022,True,92.38408350697503,addition,text
5.2680818999999985,43,17,60,60,Jan-27-2022,True,72.2473130948924,addition,text
3.2777485999999953,44,21,65,65,Jan-27-2022,True,89.25636411519807,addition,text
4.616528299999999,37,16,53,53,Jan-27-2022,True,78.68766645529912,addition,text
2.910609199999982,50,31,81,81,Jan-27-2022,True,91.52835408487546,addition,text
3.6088386999999784,7,37,44,44,Jan-27-2022,True,86.97628323738246,addition,text
3.0897283999999843,6,50,56,56,Jan-27-2022,True,90.45357841423353,addition,text
3.5819556000000006,40,49,89,89,Feb-18-2022,True,87.16959407962864,addition,text
4.393802899999997,27,49,76,76,Feb-18-2022,True,80.69449607595162,addition,text
2.0165390000000016,30,22,52,52,Feb-18-2022,True,95.933570461479,addition,text
3.818054200000006,23,14,37,37,Feb-18-2022,True,85.42246212586231,addition,text
1.932545900000001,6,40,46,46,Feb-18-2022,True,96.26526634439318,addition,text
1.8886406000000022,46,50,96,96,Feb-18-2022,True,96.43303668403163,addition,text
1.8416958999999977,10,19,29,29,Feb-18-2022,True,96.6081562119232,addition,text
6.140675099999996,48,25,73,73,Feb-18-2022,True,62.292109316240044,addition,text
2.8033714999999972,37,9,46,46,Feb-18-2022,True,92.14110823298776,addition,text
4.9808730000000025,13,25,38,38,Feb-18-2022,True,75.19090415787097,addition,text
5.176698599999995,47,28,75,75,Feb-18-2022,True,73.2017916047581,addition,text
5.268822899999989,44,36,80,80,Feb-18-2022,True,72.2395052484357,addition,text
7.796454799999992,17,26,43,43,Feb-18-2022,True,39.215292551557084,addition,text
3.9994292000000087,31,16,47,47,Feb-18-2022,True,84.0045660741873,addition,text
4.409447400000005,22,34,56,56,Feb-18-2022,True,80.5567736266332,addition,text
4.412175300000001,50,27,77,77,Feb-18-2022,True,80.5327091220699,addition,text
3.6474170000000044,13,23,36,46,Feb-18-2022,False,0.0,addition,text
3.8084494999999947,34,38,72,72,Feb-18-2022,True,85.49571240594979,addition,text
8.178311499999992,37,16,53,53,Feb-18-2022,True,33.11522100896788,addition,text
