time,num1,num2,result,answer,date,correct,score,problem_type
5.185412000000042,23,26,49,49,Apr-11-2020,1,73.11150239025557,addition
9.0179713,38,45,83,83,Apr-11-2020,1,18.676193632376325,addition
3.842767900000013,34,16,50,50,Apr-11-2020,1,85.23313486672949,addition
3.2143022999999857,49,11,60,60,Apr-11-2020,1,89.6682607242148,addition
3.8569170999999187,41,25,66,66,Apr-11-2020,1,85.12419048372821,addition
3.900953800000025,32,37,69,69,Apr-11-2020,1,84.78255945026537,addition
5.4523642999999975,16,29,45,45,Apr-11-2020,1,70.27172354008553,addition
3.5239010999999887,4,48,52,52,Apr-11-2020,1,87.58212103741887,addition
5.023548699999992,46,21,67,67,Apr-11-2020,1,74.76395845872838,addition
5.6724468999999536,24,48,72,72,Apr-11-2020,1,67.82334616668092,addition
7.766603100000111,40,19,59,59,Apr-11-2020,1,39.67987628706866,addition
5.3205985000000755,32,46,78,78,Apr-11-2020,1,71.69123160179694,addition
1.7189144999999826,4,3,7,7,Apr-11-2020,1,97.04533294168981,addition
2.072268000000008,4,40,44,44,Apr-11-2020,1,95.70570533617597,addition
4.010642099999926,33,32,65,65,Apr-11-2020,1,83.91474994570818,addition
2.860954300000003,6,40,46,46,Apr-11-2020,1,91.8149404933115,addition
5.871139500000028,26,43,69,69,Apr-11-2020,1,65.52972097153942,addition
2.5141980999999305,8,15,23,23,Apr-11-2020,1,93.67880791395675,addition
1.8217504000000413,2,9,11,11,Apr-11-2020,1,96.68122548009968,addition
6.474619500000018,46,39,85,85,Apr-11-2020,1,58.07930233021952,addition
3.951484700000037,28,44,72,72,Apr-11-2020,1,84.38576866566562,addition
3.8283387000000175,16,15,31,39,Apr-11-2020,0,0.0,addition
12.845158900000001,42,20,62,62,Apr-11-2020,1,0.0,addition
9.194811200000004,45,22,67,67,Apr-11-2020,1,15.455446996354496,addition
2.0320196000000124,31,1,32,32,Apr-11-2020,1,95.87089634521578,addition
5.9176356000000405,33,26,59,59,Apr-11-2020,1,64.98158890561217,addition
5.35975499999995,39,14,53,53,Apr-11-2020,1,71.27302633997553,addition
3.524637900000016,33,13,46,46,Apr-11-2020,1,87.57692767388347,addition
10.072945599999912,16,17,33,33,Apr-11-2020,1,0.0,addition
2.7005597999999518,41,4,45,45,Apr-11-2020,1,92.70697676662422,addition
1.8608912000000828,1,38,39,39,Apr-11-2020,1,96.53708394176225,addition
2.5595597000000225,18,5,23,23,Apr-11-2020,1,93.4486541421358,addition
4.217074199999956,31,46,77,77,Apr-11-2020,1,82.21628519169472,addition
6.116581099999963,35,49,84,84,Apr-11-2020,1,62.58743564712324,addition
1.284552700000063,0,1,1,1,Apr-11-2020,1,98.34992436092254,addition
2.0043292999999958,21,2,23,23,Apr-11-2020,1,95.98266405716153,addition
7.6673456999999425,14,49,63,63,Apr-11-2020,1,41.21180991669239,addition
4.567681500000049,31,11,42,42,Apr-11-2020,1,79.1362857145573,addition
6.769831299999964,26,38,64,64,Apr-11-2020,1,54.16938416954079,addition
1.7107320999999729,1,19,20,20,Apr-11-2020,1,97.07339568202968,addition
1.9390489999999545,5,40,45,45,Apr-11-2020,1,96.24008897559918,addition
7.3746556999999475,13,48,61,61,Apr-11-2020,1,45.61445330645829,addition
2.8445087000000058,30,41,71,71,Apr-11-2020,1,91.90877025562428,addition
3.186010499999952,31,19,50,50,Apr-11-2020,1,89.84933709389006,addition
2.3303756999999905,1,48,49,49,Apr-11-2020,1,94.56934909684955,addition
4.871107199999983,33,23,56,56,Apr-11-2020,1,76.27231464610833,addition
3.3422841000000285,6,13,19,19,Apr-11-2020,1,88.829136994887,addition
2.1988251999999875,33,10,43,43,Apr-11-2020,1,95.16516773984502,addition
4.350320399999987,23,17,40,40,Apr-11-2020,1,81.07471241734396,addition
2.602731100000028,40,11,51,51,Apr-11-2020,1,93.22579082109264,addition
2.472166299999799,16,11,27,27,Apr-13-2020,1,93.8883937851453,addition
2.159728899999891,27,6,33,33,Apr-13-2020,1,95.33557107850527,addition
2.1919414999999844,10,26,36,36,Apr-13-2020,1,95.19539246057782,addition
8.256262699999981,38,45,83,83,Apr-13-2020,1,31.834126228589028,addition
2.25565070000016,20,40,60,60,Apr-13-2020,1,94.91203991958879,addition
1.8551857999998451,3,36,39,39,Apr-13-2020,1,96.55828564747894,addition
1.056123800000023,1,3,4,4,Apr-13-2020,1,98.88460251907351,addition
5.793010999999979,24,34,58,58,Apr-13-2020,1,66.44102355387925,addition
3.1982748000000365,28,5,33,33,Apr-13-2020,1,89.77103830368472,addition
1.7044409000000087,12,6,18,18,Apr-13-2020,1,97.09488121840717,addition
5.359228699999903,42,17,59,59,Apr-13-2020,1,71.27866774109735,addition
2.0798440999999457,1,48,49,49,Apr-13-2020,1,95.67424851969541,addition
5.575754599999981,16,42,58,58,Apr-13-2020,1,68.91096064057905,addition
5.137400499999785,26,8,34,34,Apr-13-2020,1,73.60711610260196,addition
1.2860750999998345,0,0,0,0,Apr-13-2020,1,98.34601083716042,addition
3.4639138000000003,33,20,53,53,Apr-13-2020,1,88.00130118616956,addition
6.256290499999977,45,26,71,71,Apr-13-2020,1,60.858829179610034,addition
1.7837478999999803,3,18,21,21,Apr-13-2020,1,96.81824342924565,addition
6.855308299999932,49,29,78,78,Apr-13-2020,1,53.00474811195204,addition
2.0799317999999403,1,16,17,17,Apr-13-2020,1,95.673883707349,addition
4.366797300000144,41,17,58,58,Apr-13-2020,1,80.93108134071146,addition
4.311672200000204,5,21,26,26,Apr-13-2020,1,81.40948283974541,addition
4.913007899999911,22,35,57,57,Apr-13-2020,1,75.86235337453846,addition
4.631610099999988,15,46,61,61,Apr-13-2020,1,78.5481878815781,addition
4.224082500000122,34,14,48,48,Apr-13-2020,1,82.15712703319272,addition
1.7034641999998712,24,1,25,25,Apr-13-2020,1,97.0982097193188,addition
2.4708387000000585,46,6,52,52,Apr-13-2020,1,93.89495611858202,addition
2.1040583999999853,44,2,46,46,Apr-13-2020,1,95.5729382493895,addition
3.784080199999835,3,21,24,24,Apr-13-2020,1,85.68073703996922,addition
5.031158900000037,13,28,41,41,Apr-13-2020,1,74.68744012295042,addition
2.696667499999876,4,44,48,48,Apr-13-2020,1,92.72798439444442,addition
2.6069943999998486,10,16,26,26,Apr-13-2020,1,93.20358019836942,addition
4.527562999999873,31,24,55,55,Apr-13-2020,1,79.50117328103215,addition
4.064970899999935,12,14,26,26,Apr-13-2020,1,83.47601158215372,addition
2.8229145999998764,30,33,63,63,Apr-13-2020,1,92.03115316110754,addition
2.464122300000099,15,17,32,32,Apr-13-2020,1,93.92810129064222,addition
3.6465210999999726,23,14,37,37,Apr-13-2020,1,86.702883867255,addition
3.2637161000000035,6,49,55,55,Apr-15-2020,1,89.34815721860076,addition
4.096177300000001,41,37,78,78,Apr-15-2020,1,83.2213315269647,addition
4.1532332999999975,28,28,56,56,Apr-15-2020,1,82.75065315577113,addition
4.327528200000003,48,47,95,95,Apr-15-2020,1,81.27249967820472,addition
3.895934099999998,45,13,58,58,Apr-15-2020,1,84.8216974884572,addition
1.8867073999999988,2,18,20,20,Apr-15-2020,1,96.44033518678525,addition
2.1748908,4,30,34,34,Apr-15-2020,1,95.26985000807537,addition
3.9764464,11,35,46,46,Apr-15-2020,1,84.18787402792704,addition
5.182558999999999,15,28,43,43,Apr-15-2020,1,73.14108221151902,addition
1.8320815000000008,15,3,18,18,Apr-15-2020,1,96.64347737735774,addition
3.183680899999999,41,19,60,60,Apr-15-2020,1,89.8641759269752,addition
5.9997510999999975,7,48,55,55,Apr-15-2020,1,64.00298673804882,addition
7.128830499999991,46,9,55,55,Apr-15-2020,1,49.17977570226987,addition
1.7589239999999933,19,0,19,19,Apr-15-2020,1,96.90618636222402,addition
3.0554453000000024,42,9,51,49,Apr-15-2020,0,15.978286168371056,addition
4.913029199999997,42,42,84,84,Apr-15-2020,1,75.8621440799474,addition
3.566478100000012,11,35,46,46,Apr-15-2020,1,87.28023396222031,addition
6.616493199999994,48,27,75,75,Apr-15-2020,1,56.22201773435384,addition
3.9831799000000094,35,15,50,40,Apr-15-2020,0,0.0,addition
5.2793015000000025,35,35,70,70,Apr-15-2020,1,72.12897567209772,addition
3.432089000000005,10,39,49,49,Apr-15-2020,1,88.22076509607896,addition
2.895536899999996,6,11,17,17,Apr-15-2020,1,91.61586606073841,addition
4.424296699999998,14,48,62,62,Apr-15-2020,1,80.42559871036912,addition
2.8248702999999864,16,6,22,22,Apr-15-2020,1,92.02010778817798,addition
4.919355600000016,22,13,35,35,Apr-15-2020,1,75.79994048074848,addition
2.4626037999999824,16,9,25,25,Apr-15-2020,1,93.93558252422565,addition
5.456358600000017,45,17,62,62,Apr-15-2020,1,70.22815082820586,addition
5.2155970999999965,29,48,77,77,Apr-15-2020,1,72.79754689047162,addition
3.2648028000000124,39,20,59,59,Apr-15-2020,1,89.34106267711208,addition
6.791249899999998,23,19,42,42,Apr-15-2020,1,53.878924795750024,addition
1.9030047999999908,21,1,22,22,Apr-15-2020,1,96.378572731177,addition
3.9030360000006112,19,41,60,60,Apr-16-2020,1,84.76630998269923,addition
3.9034750000000713,11,49,60,60,Apr-16-2020,1,84.76288292437444,addition
7.504598900000019,33,16,49,49,Apr-16-2020,1,43.6809953501185,addition
4.591106700000637,6,37,43,43,Apr-16-2020,1,78.92173926920927,addition
2.215396700000383,31,30,61,61,Apr-16-2020,1,95.0920174616274,addition
6.1999221999994925,16,27,43,43,Apr-16-2020,1,61.56096471395345,addition
3.8651582000002236,38,28,66,66,Apr-16-2020,1,85.06055208897104,addition
2.5200046999998453,30,24,54,54,Apr-16-2020,1,93.64957631197869,addition
2.574893599999996,6,37,43,43,Apr-16-2020,1,93.36992294867906,addition
1.8790918999993664,30,12,42,42,Apr-16-2020,1,96.46901363135677,addition
2.63233130000026,5,31,36,36,Apr-16-2020,1,93.07083192703894,addition
1.8871718000000328,45,1,46,46,Apr-16-2020,1,96.43858259728464,addition
6.168507200000023,39,42,81,81,Apr-16-2020,1,61.94951892354788,addition
4.974960600000486,19,24,43,43,Apr-16-2020,1,75.2497670284428,addition
1.784056999999848,43,0,43,43,Apr-16-2020,1,96.81714062075154,addition
1.056100200000401,33,0,33,33,Apr-16-2020,1,98.88465236755911,addition
1.9514195000001564,12,7,19,19,Apr-16-2020,1,96.19196193501914,addition
5.872843600000124,12,31,43,43,Apr-16-2020,1,65.50970804993759,addition
1.734532200000103,40,2,42,42,Apr-16-2020,1,96.9913980471628,addition
2.408377400000063,19,3,22,22,Apr-16-2020,1,94.19971829916894,addition
2.5025556000000506,28,6,34,24,Apr-16-2020,0,0.0,addition
8.015781400000378,33,49,82,82,Apr-16-2020,1,35.74724854740798,addition
2.0644697999996424,3,26,29,29,Apr-16-2020,1,95.73796444488944,addition
3.2649811000001137,10,32,42,42,Apr-16-2020,1,89.33989841664204,addition
1.7098153000006278,19,2,21,21,Apr-16-2020,1,97.07653163988377,addition
3.840470899999673,25,28,53,52,Apr-16-2020,0,41.00313306502281,addition
10.175192800000332,6,14,20,20,Apr-16-2020,1,0.0,addition
3.6643679999997403,37,37,74,74,Apr-16-2020,1,86.57240716057791,addition
4.839384500000051,45,12,57,57,Apr-16-2020,1,76.58035766115925,addition
2.008485300000757,38,1,39,39,Apr-16-2020,1,95.96598679968086,addition
4.047027100000378,31,37,68,68,Apr-16-2020,1,83.62157165186252,addition
4.5919801999998535,38,23,61,61,Apr-16-2020,1,78.9137178428093,addition
1.983285700000124,38,3,41,41,Apr-16-2020,1,96.06657783217501,addition
2.0648659000007683,8,22,30,30,Apr-16-2020,1,95.73632881501402,addition
2.48649260000002,15,14,29,29,Apr-16-2020,1,93.81735455014514,addition
1.6398967000004632,2,24,26,26,Apr-16-2020,1,97.31073881332759,addition
3.2160603000002084,11,14,25,25,Apr-16-2020,1,89.65695614676257,addition
3.3769813999997496,18,15,33,33,Apr-16-2020,1,88.59599662405573,addition
2.8944185000000284,41,19,60,60,Apr-16-2020,1,91.62234154685758,addition
6.767965600000025,33,22,55,55,Apr-16-2020,1,54.1946416372163,addition
2.2637196000005133,6,32,38,38,Apr-16-2020,1,94.87557357257351,addition
3.8479276999996728,21,26,47,47,Apr-16-2020,1,85.19345241557522,addition
1.823610200000076,30,11,41,41,Apr-16-2020,1,96.67444583845568,addition
1.4801802000001771,23,3,26,26,Apr-16-2020,1,97.80906657552744,addition
5.848070299999563,44,23,67,67,Apr-16-2020,1,65.80007376626303,addition
2.8076939000002312,20,42,62,62,Apr-16-2020,1,92.11685496390149,addition
4.8236206000001385,19,29,48,48,Apr-16-2020,1,76.7326843072543,addition
1.3429015000001527,4,6,10,10,Apr-16-2020,1,98.19661556129734,addition
5.391576099999837,23,5,28,28,Apr-16-2020,1,70.93090715791055,addition
2.8395923000007315,13,11,24,24,Apr-16-2020,1,91.93671556977655,addition
6.720215899999857,29,47,76,76,Apr-16-2020,1,54.838698257389105,addition
2.6642784999994547,30,39,69,69,Apr-16-2020,1,92.90162007444066,addition
2.416854600000079,6,43,49,49,Apr-16-2020,1,94.15881384245846,addition
6.231521000000613,46,29,75,75,Apr-16-2020,1,61.16814602655136,addition
5.480333000000428,36,23,59,59,Apr-16-2020,1,69.96595020910631,addition
4.277792699999736,31,29,60,60,Apr-16-2020,1,81.70048961582897,addition
1.5113087999998245,29,0,29,29,Apr-16-2020,1,97.71594571104309,addition
2.4487693999999465,18,7,25,25,Apr-16-2020,1,94.0035284256239,addition
5.07157289999941,48,31,79,79,Apr-16-2020,1,74.27914831999158,addition
7.591698700000053,30,19,49,49,Apr-16-2020,1,42.36611084841751,addition
5.27222729999994,7,36,43,43,Apr-16-2020,1,72.20361929713533,addition
3.264050199999473,46,11,57,57,Apr-16-2020,1,89.3459762918834,addition
1.583667300000343,3,8,11,11,Apr-16-2020,1,97.49199788290963,addition
2.791059200000745,3,49,52,52,Apr-16-2020,1,92.2099885420912,addition
5.175777399999788,21,18,39,39,Apr-16-2020,1,73.21132830565143,addition
1.6157852999995157,8,3,11,11,Apr-16-2020,1,97.38923786430547,addition
2.504362199999377,40,24,64,64,Apr-16-2020,1,93.72816997121429,addition
4.39156550000007,14,34,48,48,Apr-16-2020,1,80.71415245920915,addition
5.416112599999906,27,17,44,44,Apr-16-2020,1,70.66572430412226,addition
8.831317900000045,38,29,67,67,Apr-22-2020,1,22.0078241491388,addition
3.144131600000037,31,32,63,63,Apr-22-2020,1,90.1144364818812,addition
3.7514787000000065,30,16,46,46,Apr-22-2020,1,85.92640756344626,addition
3.712536,32,24,56,56,Apr-22-2020,1,86.217076448704,addition
3.407613700000013,24,46,70,70,Apr-22-2020,1,88.38816887157222,addition
3.1431087999999936,3,49,52,52,Apr-22-2020,1,90.1208670713626,addition
5.167588599999988,8,19,27,27,Apr-22-2020,1,73.29602806115017,addition
2.2322985999999787,17,4,21,21,Apr-22-2020,1,95.01684296043814,addition
4.312292599999978,13,44,57,57,Apr-22-2020,1,81.40413253198543,addition
3.1588368999999825,24,9,33,33,Apr-22-2020,1,90.0217494391985,addition
3.7518206999999957,45,14,59,59,Apr-22-2020,1,85.92384143505154,addition
3.3920075999999995,34,21,55,55,Apr-22-2020,1,88.49428444154225,addition
10.11191180000003,38,9,47,47,Apr-22-2020,1,0.0,addition
10.983909700000027,45,18,63,63,Apr-22-2020,1,0.0,addition
2.430923100000029,7,12,19,19,Apr-22-2020,1,94.09061288188624,addition
5.376446199999975,8,41,49,49,Apr-22-2020,1,71.09382625850583,addition
4.022816199999966,34,48,82,82,Apr-22-2020,1,83.81694982101783,addition
3.3283468000000203,32,15,47,47,Apr-22-2020,1,88.92210757892963,addition
2.1602907000000187,1,49,50,50,Apr-22-2020,1,95.33314409149342,addition
2.3668422000000082,11,18,29,29,Apr-22-2020,1,94.39805800029912,addition
7.119860300000028,23,19,42,42,Apr-22-2020,1,49.307589308483514,addition
6.7760564999999815,45,21,66,66,Apr-22-2020,1,54.085058308808,addition
4.272255900000005,41,35,76,76,Apr-22-2020,1,81.74782952491515,addition
5.192145200000027,47,35,82,82,Apr-22-2020,1,73.04162822211669,addition
4.903849400000013,32,39,71,71,Apr-22-2020,1,75.95226106211952,addition
2.3035755999999883,3,33,36,36,Apr-22-2020,1,94.69353945508469,addition
1.952347400000008,5,19,24,24,Apr-22-2020,1,96.18833962971321,addition
3.471208400000023,6,29,35,35,Apr-22-2020,1,87.95071224376927,addition
1.4718398999999636,28,1,29,29,Apr-22-2020,1,97.83368730876809,addition
3.6236531000000127,40,49,89,89,Apr-22-2020,1,86.8691382108603,addition
5.327968499999997,42,36,78,78,Apr-22-2020,1,71.61275166300778,addition
3.022703500000034,43,41,84,84,Apr-22-2020,1,90.86326355108754,addition
2.5288305000000264,0,37,37,37,Apr-22-2020,1,93.60501630226962,addition
6.32735120000001,18,38,56,56,Apr-22-2020,1,59.964626791858436,addition
2.8556111999999985,20,29,49,49,Apr-22-2020,1,91.84548467443457,addition
5.7035847999999865,8,27,35,35,Apr-22-2020,1,67.46912042920911,addition
3.648102800000004,33,18,51,51,Apr-22-2020,1,86.69134596063213,addition
5.295416099999954,14,21,35,35,Apr-22-2020,1,71.95856832786127,addition
2.231414700000016,35,3,38,38,Apr-22-2020,1,95.02078843662383,addition
2.7124756999999704,46,10,56,56,Apr-22-2020,1,92.64247557690967,addition
1.599348399999997,10,30,40,40,Apr-22-2020,1,97.44208469541745,addition
3.2479991000000155,40,39,79,79,Apr-22-2020,1,89.45050184639909,addition
2.8393949000000016,49,49,98,98,Apr-22-2020,1,91.93783660185397,addition
2.632307199999957,17,15,32,32,Apr-22-2020,1,93.0709588048284,addition
4.3827417999999625,34,44,78,77,Apr-22-2020,0,23.16629725813236,addition
7.871634300000039,24,10,34,34,Apr-22-2020,1,38.03737344706289,addition
5.288182800000016,49,16,65,65,Apr-22-2020,1,72.03512267378399,addition
1.8876968000000147,10,30,40,40,Apr-22-2020,1,96.43660079126971,addition
2.2476406000000106,22,20,42,42,Apr-22-2020,1,94.9481117332316,addition
3.8385711999999903,32,19,51,51,Apr-22-2020,1,85.26537114253064,addition
3.9524374999999736,24,31,55,55,Apr-22-2020,1,84.37823780859395,addition
3.535420799999997,28,42,70,70,Apr-22-2020,1,87.50079976692739,addition
7.319818599999963,9,24,33,33,Apr-22-2020,1,46.42025566309458,addition
4.568642199999998,45,43,88,88,Apr-22-2020,1,79.12750844837917,addition
3.5108807000000297,11,4,15,15,Apr-22-2020,1,87.6737167103673,addition
3.3680215999999064,27,12,39,39,Apr-22-2020,1,88.65643050193407,addition
4.264012600000001,34,26,60,80,Apr-22-2020,0,0.0,addition
13.551420200000052,23,48,71,71,Apr-22-2020,1,0.0,addition
3.7590418999999433,39,12,51,51,Apr-22-2020,1,85.86960399404481,addition
6.008530300000075,16,22,38,38,Apr-22-2020,1,63.89756363398101,addition
5.0950169999999835,13,48,61,61,Apr-22-2020,1,74.04080176971117,addition
5.192137300000012,23,40,63,63,Apr-22-2020,1,73.04171025794858,addition
4.991128799999956,29,36,65,65,Apr-22-2020,1,75.088633301811,addition
6.256260999999995,35,12,47,47,Apr-22-2020,1,60.85919829987906,addition
3.1666781999999785,11,27,38,38,Apr-22-2020,1,89.9721491776449,addition
6.328489999999987,47,15,62,62,Apr-22-2020,1,59.95021431990016,addition
4.782997300000034,13,38,51,51,Apr-22-2020,1,77.1229368281924,addition
4.247593399999913,41,24,65,65,Apr-22-2020,1,81.95795030827718,addition
2.5200721999999587,46,6,52,52,Apr-22-2020,1,93.64923610678737,addition
6.119933299999957,27,30,57,57,Apr-22-2020,1,62.54641640355164,addition
5.5360499,29,40,69,69,Oct-31-2021,1,69.35215150471,addition
