time,num1,num2,result,answer,date,correct,score,problem_type
2.2824828999998767,18,3,21,21,Apr-11-2020,1,94.79027181120816,addition
1.4246428999999807,12,12,24,24,Apr-11-2020,1,97.97039260747964,addition
1.46894199999997,9,9,18,18,Apr-11-2020,1,97.8422094006361,addition
1.4299229999999168,16,1,17,17,Apr-11-2020,1,97.95532021407124,addition
1.3873340000000098,18,1,19,19,Apr-11-2020,1,98.07530437244397,addition
1.5391901000000416,4,15,19,19,Apr-11-2020,1,97.63089383606186,addition
1.6739845999998124,13,4,17,17,Apr-11-2020,1,97.19777555896347,addition
1.2597714999999423,0,16,16,16,Apr-11-2020,1,98.4129757677879,addition
2.17835910000008,17,7,24,24,Apr-11-2020,1,95.25475163144684,addition
5.899934300000041,19,17,36,36,Apr-11-2020,1,65.19077525568304,addition
1.8187986999998884,2,17,19,19,Apr-11-2020,1,96.69197128887872,addition
3.7195683999998437,13,15,28,28,Apr-11-2020,1,86.1648109177226,addition
1.5111696000001302,0,10,10,10,Apr-11-2020,1,97.71636644003544,addition
1.6694637999999031,17,7,24,24,Apr-11-2020,1,97.21289062048989,addition
2.3021052000001423,12,5,17,18,Apr-11-2020,0,78.80124659252922,addition
6.8980488999998215,8,12,20,20,Apr-11-2020,1,52.41692137321125,addition
1.7117462999999589,1,19,20,20,Apr-11-2020,1,97.06992460443645,addition
3.5065916999999445,13,14,27,27,Apr-11-2020,1,87.7038146494915,addition
3.1604314999999588,17,13,30,30,Apr-11-2020,1,90.01167273380801,addition
1.467117000000144,0,13,13,13,Apr-11-2020,1,97.84756770831058,addition
1.440722600000072,13,13,26,26,Apr-11-2020,1,97.92431838984903,addition
5.80900399999996,7,16,23,23,Apr-11-2020,1,66.25547252798447,addition
2.8287823999999087,16,12,28,28,Apr-11-2020,1,91.99799013345076,addition
2.3677058000000666,19,11,30,30,Apr-11-2020,1,94.39396924464604,addition
1.972465800000009,1,19,20,20,Apr-11-2020,1,96.10937866783033,addition
1.6954972999999427,17,1,18,18,Apr-11-2020,1,97.1252889056929,addition
4.3012456000001285,4,13,17,17,Apr-11-2020,1,81.49928628847954,addition
1.833275400000048,6,12,18,18,Apr-11-2020,1,96.63910130775466,addition
2.6353484000001117,8,9,17,17,Apr-11-2020,1,93.05493881061685,addition
2.936943100000008,3,19,22,22,Apr-11-2020,1,91.37436522736235,addition
2.7377796000000667,19,5,24,24,Apr-11-2020,1,92.50456286182347,addition
2.6538106999998945,11,3,14,14,Apr-11-2020,1,92.95728876856607,addition
1.4309912999999597,1,15,16,16,Apr-11-2020,1,97.95226389932442,addition
1.1508248000000094,0,6,6,6,Apr-11-2020,1,98.67560227970493,addition
1.2881301000002168,1,16,17,17,Apr-11-2020,1,98.34072084547343,addition
1.2457091999999648,1,16,17,17,Apr-11-2020,1,98.44820858903545,addition
2.5292384000001675,5,8,13,13,Apr-11-2020,1,93.6029531159646,addition
8.234594699999889,19,13,32,32,Apr-11-2020,1,32.19145012673374,addition
3.3730465999999524,16,5,21,21,Apr-11-2020,1,88.62255663422876,addition
3.1134832000000188,10,18,28,28,Apr-11-2020,1,90.30622236331764,addition
1.3094561000000342,1,4,5,5,Apr-11-2020,1,98.2853247221727,addition
2.3362425999998777,6,18,24,24,Apr-11-2020,1,94.54197051394581,addition
1.89296719999993,3,14,17,17,Apr-11-2020,1,96.41667517972442,addition
2.700914399999874,10,17,27,27,Apr-11-2020,1,92.70506140387332,addition
1.5425422000000708,17,1,18,18,Apr-11-2020,1,97.62056356121894,addition
1.5194830000000366,10,6,16,16,Apr-11-2020,1,97.69117141271089,addition
1.7279344999999466,5,2,7,7,Apr-11-2020,1,97.01424236370994,addition
3.25561689999995,16,7,23,23,Apr-11-2020,1,89.40095860043472,addition
1.5078282000001764,13,0,13,13,Apr-11-2020,1,97.72645411928423,addition
1.7512378999999785,14,15,29,29,Apr-11-2020,1,96.93316581760367,addition
2.4356860999998844,9,7,16,16,Apr-11-2020,1,94.06743322226735,addition
8.235108899999886,17,18,35,35,Apr-11-2020,1,32.182981405142655,addition
1.5172459000000345,6,4,10,10,Apr-11-2020,1,97.69796487893308,addition
0.9845106000000214,2,0,2,2,Apr-11-2020,1,99.0307388784876,addition
1.8630410000000663,3,12,15,15,Apr-11-2020,1,96.52907823231875,addition
2.6751844000000347,18,4,22,22,Apr-11-2020,1,92.84338842599645,addition
1.7478971000000456,6,15,21,21,Apr-11-2020,1,96.94485572781143,addition
2.000182900000026,3,17,20,20,Apr-11-2020,1,95.99926836654748,addition
1.244776899999806,13,0,13,13,Apr-11-2020,1,98.45053046922688,addition
1.5567714999999682,7,13,20,20,Apr-11-2020,1,97.57646249678785,addition
1.844713899999988,2,16,18,18,Apr-11-2020,1,96.59703062714684,addition
2.072718699999996,3,19,22,22,Apr-11-2020,1,95.70383719067033,addition
1.239140599999928,4,10,14,14,Apr-11-2020,1,98.46453057343182,addition
1.7563282000000981,14,2,16,16,Apr-11-2020,1,96.91531125388441,addition
1.072868399999834,0,9,9,9,Apr-11-2020,1,98.8489533962818,addition
2.453637800000024,16,12,28,28,Apr-11-2020,1,93.97966154641104,addition
1.4617063000000603,15,15,30,30,Apr-11-2020,1,97.86341469254013,addition
2.3332843000000603,11,10,21,21,Apr-11-2020,1,94.55578437537324,addition
1.2007042000000183,14,1,15,15,Apr-11-2020,1,98.55830942410232,addition
1.1696075999998357,1,14,15,15,Apr-11-2020,1,98.63201806202262,addition
1.248689000000013,3,4,7,7,Apr-11-2020,1,98.44077578127897,addition
5.269588499999827,12,19,31,31,Apr-11-2020,1,72.23143704066958,addition
1.6111137000000326,6,8,14,14,Apr-11-2020,1,97.4043126456722,addition
2.001113400000122,1,11,12,12,Apr-11-2020,1,95.99554516033996,addition
2.6261312999999973,4,11,15,15,Apr-11-2020,1,93.10343439516032,addition
3.114540199999965,15,8,23,23,Apr-11-2020,1,90.29963934258419,addition
4.021951700000045,16,16,32,32,Apr-11-2020,1,83.82390452286674,addition
2.112638699999934,17,13,30,30,Apr-11-2020,1,95.53675772326258,addition
3.7322670999999445,10,17,27,27,Apr-11-2020,1,86.070182294258,addition
1.6983046000000286,17,3,20,20,Apr-11-2020,1,97.11576148561875,addition
1.6079669999999169,15,4,19,19,Apr-11-2020,1,97.41444212691127,addition
1.3325423999999657,15,0,15,15,Apr-11-2020,1,98.22433075220233,addition
4.595955999999887,17,14,31,31,Apr-11-2020,1,78.87718844606503,addition
1.7428615000001173,1,14,15,15,Apr-11-2020,1,96.96243379181735,addition
1.8618168999998943,19,7,26,26,Apr-11-2020,1,96.53363783087478,addition
2.450819600000159,11,15,26,26,Apr-11-2020,1,93.99348328825506,addition
1.870536599999923,5,10,15,15,Apr-11-2020,1,96.50109282806073,addition
1.4400464999998803,2,15,17,17,Apr-11-2020,1,97.9262660778381,addition
2.4869956,4,7,11,11,Apr-11-2020,1,93.81485288558063,addition
1.9882718999999724,14,3,17,17,Apr-11-2020,1,96.0467748516705,addition
2.3714263000001665,7,11,18,18,Apr-11-2020,1,94.37633730366753,addition
2.224717900000087,13,9,22,22,Apr-11-2020,1,95.0506302654192,addition
1.2778178999999454,5,3,8,8,Apr-11-2020,1,98.36718141443973,addition
1.4115908000001127,1,19,20,20,Apr-11-2020,1,98.00741141335504,addition
1.8852938,7,4,11,11,Apr-13-2020,1,96.44566728768156,addition
4.464313599999969,18,7,25,25,Apr-13-2020,1,80.06990408085532,addition
2.0236869999998817,11,4,15,15,Apr-13-2020,1,95.90469092603148,addition
2.575174500000003,18,7,25,25,Apr-13-2020,1,93.36847629454974,addition
2.3115222999999787,14,5,19,19,Apr-13-2020,1,94.6568646566028,addition
1.7764760000000024,4,18,22,22,Apr-13-2020,1,96.84413302142399,addition
4.670587699999942,18,19,37,37,Apr-13-2020,1,78.18561053660926,addition
2.673004600000013,11,14,25,25,Apr-13-2020,1,92.85504640837877,addition
1.5911140000000614,2,16,18,18,Apr-13-2020,1,97.46835623900381,addition
2.3191796999999497,1,6,7,7,Apr-13-2020,1,94.62140551910814,addition
1.640741799999887,16,16,32,32,Apr-13-2020,1,97.30796634573313,addition
1.295087599999988,1,9,10,10,Apr-13-2020,1,98.32274810832627,addition
2.8803505999999284,19,16,35,35,Apr-13-2020,1,91.70358042108005,addition
5.647499299999938,13,19,32,32,Apr-13-2020,1,68.10575165650022,addition
1.7837176000000454,2,15,17,17,Apr-13-2020,1,96.81835152345008,addition
2.3527139999998776,19,3,22,22,Apr-13-2020,1,94.46473683420457,addition
2.9743782999998984,16,7,23,23,Apr-13-2020,1,91.15307372848972,addition
2.2557226999999784,9,15,24,24,Apr-13-2020,1,94.91171510070481,addition
4.07280720000017,16,17,33,33,Apr-13-2020,1,83.41224151162677,addition
4.254814500000066,9,8,17,17,Apr-13-2020,1,81.89655357058919,addition
2.4082765999999083,17,13,30,30,Apr-13-2020,1,94.20020381789288,addition
1.4078374999999141,8,4,12,12,Apr-13-2020,1,98.017993573594,addition
1.5594882999998845,16,8,24,24,Apr-13-2020,1,97.56799624216347,addition
1.3993989999999032,8,10,18,18,Apr-13-2020,1,98.04168243879927,addition
1.3518268000000262,11,11,22,22,Apr-13-2020,1,98.17256430280169,addition
1.0790761999999177,1,5,6,6,Apr-13-2020,1,98.83559455459374,addition
2.688315899999907,5,16,21,21,Apr-13-2020,1,92.77295762180769,addition
1.247619499999928,2,0,2,2,Apr-13-2020,1,98.44344558321993,addition
3.9996704000000136,14,9,23,23,Apr-13-2020,1,84.00263669136373,addition
1.4159998999998606,12,0,12,12,Apr-13-2020,1,97.99494428320038,addition
2.5276117999999315,9,17,26,26,Apr-13-2020,1,93.6111785885011,addition
4.415894200000139,4,17,21,21,Apr-13-2020,1,80.49987841440513,addition
1.880025600000181,15,9,24,24,Apr-13-2020,1,96.46550374334396,addition
1.86419520000004,4,16,20,20,Apr-13-2020,1,96.52477625629682,addition
1.5353121000000556,15,5,20,20,Apr-13-2020,1,97.64281675559342,addition
1.4079216999998607,5,2,7,7,Apr-13-2020,1,98.0177564866695,addition
1.2312414999998964,5,1,6,6,Apr-13-2020,1,98.484044368678,addition
1.9458789000000247,11,9,20,20,Apr-13-2020,1,96.21355530653469,addition
2.1097611000000143,5,16,21,21,Apr-13-2020,1,95.54890810092672,addition
1.6243008000001282,15,3,18,18,Apr-13-2020,1,97.36164691111894,addition
1.9598515000000127,17,4,21,21,Apr-13-2020,1,96.1589820979477,addition
2.9367072000000007,2,11,13,13,Apr-13-2020,1,91.37575082146816,addition
1.3188556999998582,5,5,10,10,Apr-13-2020,1,98.26061964257788,addition
2.6801688999998987,14,9,23,23,Apr-13-2020,1,92.81669466747333,addition
2.5670577000000776,17,11,28,28,Apr-13-2020,1,93.41021476487032,addition
5.1272348999998485,12,15,27,27,Apr-13-2020,1,73.71146228022354,addition
1.6082034999999453,13,7,20,20,Apr-13-2020,1,97.41368150258792,addition
1.0080410000000484,0,5,5,5,Apr-13-2020,1,98.98385334231891,addition
1.6553989000001366,6,8,14,14,Apr-13-2020,1,97.25965448187834,addition
2.2954595999999583,9,15,24,24,Apr-13-2020,1,94.73086522476802,addition
2.3598558999999573,8,13,21,21,Apr-13-2020,1,94.43108013123539,addition
2.2956973000000294,18,10,28,28,Apr-13-2020,1,94.72977390677258,addition
1.4871349999998529,0,4,4,4,Apr-13-2020,1,97.78842949177543,addition
4.9286722000001655,11,12,23,23,Apr-13-2020,1,75.70819034494554,addition
1.838710800000172,10,11,21,21,Apr-13-2020,1,96.61914259396272,addition
3.94504169999982,18,11,29,29,Apr-13-2020,1,84.43664598526253,addition
5.582060599999976,16,6,22,22,Apr-13-2020,1,68.84059945792791,addition
1.0724134000001868,1,3,4,4,Apr-13-2020,1,98.84992949950004,addition
1.0390012000000295,1,4,5,5,Apr-13-2020,1,98.9204765063985,addition
2.408378099999936,17,6,23,23,Apr-13-2020,1,94.1997149274407,addition
3.5046857999998338,11,19,30,30,Apr-13-2020,1,87.71717744327952,addition
2.606960900000104,19,6,25,25,Apr-13-2020,1,93.20375486587065,addition
1.9199894000000768,16,8,24,24,Apr-13-2020,1,96.31364070388734,addition
1.72647209999991,4,16,20,20,Apr-13-2020,1,97.0192940879219,addition
5.792199299999992,16,17,33,33,Apr-13-2020,1,66.4504272690796,addition
1.248022100000071,4,0,4,4,Apr-13-2020,1,98.44244083791142,addition
1.4793595999999525,2,6,8,8,Apr-13-2020,1,97.81149517388798,addition
4.3524946,16,10,26,26,Apr-13-2020,1,81.05579075697084,addition
4.991405299999997,19,18,37,37,Apr-13-2020,1,75.08587313113195,addition
6.159686999999849,13,14,27,27,Apr-13-2020,1,62.05825606203286,addition
1.783416399999851,10,1,11,11,Apr-13-2020,1,96.81942594421157,addition
2.0482463999999254,5,8,13,13,Apr-13-2020,1,95.80468668488734,addition
1.9835782999998628,2,9,11,11,Apr-13-2020,1,96.06541712776965,addition
2.0313570999999238,11,8,19,19,Apr-13-2020,1,95.8735883322799,addition
1.5728485999999862,1,14,15,15,Apr-15-2020,1,97.52614728147809,addition
2.4717313000000445,11,12,23,23,Apr-15-2020,1,93.89054438060009,addition
1.191235699999993,16,0,16,16,Apr-15-2020,1,98.58095750704553,addition
1.6484543000000258,6,5,11,11,Apr-15-2020,1,97.28259842081142,addition
1.599289199999987,9,4,13,13,Apr-15-2020,1,97.4422740547634,addition
1.3118260000000532,2,18,20,20,Apr-15-2020,1,98.27911254572386,addition
0.9031123999999976,0,0,0,0,Apr-15-2020,1,99.18438799296625,addition
1.4486549999999738,12,6,18,18,Apr-15-2020,1,97.90139869097507,addition
2.5838698999999683,11,7,18,18,Apr-15-2020,1,93.32361633987415,addition
2.2479646999999545,11,7,18,18,Apr-15-2020,1,94.94665470755412,addition
1.3029895999999894,19,1,20,20,Apr-15-2020,1,98.30221810229187,addition
4.599915399999986,17,4,21,21,Apr-15-2020,1,78.84077831284297,addition
1.9837264999999888,5,19,24,24,Apr-15-2020,1,96.0648291731978,addition
2.743107500000008,15,18,33,33,Apr-15-2020,1,92.4753612434437,addition
1.9837191000000305,10,13,23,23,Apr-15-2020,1,96.06485853229506,addition
1.1761745999999675,1,19,20,20,Apr-15-2020,1,98.61661331031492,addition
1.8726333000000184,12,11,23,23,Apr-15-2020,1,96.49324452373104,addition
0.9919012000000292,1,2,3,3,Apr-15-2020,1,99.01613200943851,addition
1.591296399999976,16,16,32,32,Apr-15-2020,1,97.46777576734712,addition
1.5916086999999948,3,16,19,19,Apr-15-2020,1,97.46678174608432,addition
2.0228649000000023,9,7,16,16,Apr-15-2020,1,95.90801759634797,addition
4.3840210000000175,9,13,22,22,Apr-15-2020,1,80.78035987155884,addition
4.2320728999999915,13,10,23,23,Apr-15-2020,1,82.08955896908566,addition
2.007946199999992,7,7,14,14,Apr-15-2020,1,95.9681520579056,addition
1.6156249000000005,11,1,12,12,Apr-15-2020,1,97.3897561825,addition
2.111463500000013,15,11,26,26,Apr-15-2020,1,95.5417218881677,addition
3.0958703000000014,3,19,22,22,Apr-15-2020,1,90.4155870855779,addition
2.976415600000053,16,7,23,23,Apr-15-2020,1,91.14095017607633,addition
1.6555119999999874,17,2,19,19,Apr-15-2020,1,97.25928001785604,addition
1.360480300000006,5,10,15,15,Apr-15-2020,1,98.1490933533119,addition
2.1992111000000136,4,14,18,18,Apr-15-2020,1,95.16347053763673,addition
2.9755091000000107,5,12,17,17,Apr-15-2020,1,91.14634559581712,addition
1.8879574000000048,11,4,15,15,Apr-15-2020,1,96.43561685578523,addition
2.11969670000002,15,13,28,28,Apr-15-2020,1,95.50688590000902,addition
1.1911531000000082,7,7,14,14,Apr-15-2020,1,98.58115429236037,addition
1.952262800000028,18,12,30,30,Apr-15-2020,1,96.18866995973605,addition
3.5116509000000065,12,19,31,31,Apr-15-2020,1,87.66830795652915,addition
1.2566534999999703,5,0,5,5,Apr-15-2020,1,98.42082198093783,addition
4.526921099999981,9,17,26,26,Apr-15-2020,1,79.50698535437496,addition
2.9757114999999885,11,8,19,19,Apr-15-2020,1,91.14514106876781,addition
1.5924991999999634,17,0,17,17,Apr-15-2020,1,97.46394629799947,addition
2.591102899999953,9,13,22,22,Apr-15-2020,1,93.28618576161183,addition
4.446904600000039,15,18,33,33,Apr-15-2020,1,80.2250394784985,addition
1.5447490999999898,4,14,18,18,Apr-15-2020,1,97.61375021804922,addition
1.6951081999999928,16,8,24,24,Apr-15-2020,1,97.12660819029279,addition
2.736521099999948,8,5,13,13,Apr-15-2020,1,92.51145226925507,addition
2.1991752000000133,7,8,15,15,Apr-15-2020,1,95.1636284397049,addition
1.3685894000000192,7,1,8,8,Apr-15-2020,1,98.1269630542076,addition
2.006910600000026,13,9,22,22,Apr-15-2020,1,95.97230984360753,addition
1.855303200000037,6,15,21,21,Apr-15-2020,1,96.55785003606962,addition
3.0395692999999824,18,7,25,15,Apr-15-2020,0,0.0,addition
3.9277223999999933,1,13,14,14,Apr-15-2020,1,84.57299674853829,addition
3.727814200000012,19,14,33,33,Apr-15-2020,1,86.10340129027827,addition
2.0877131000000304,10,12,22,22,Apr-15-2020,1,95.64145401208826,addition
3.752465499999972,5,18,23,23,Apr-15-2020,1,85.91900267130995,addition
1.8148206999999843,10,16,26,26,Apr-15-2020,1,96.70642582685157,addition
2.4560266000000297,16,17,33,25,Apr-15-2020,0,0.0,addition
10.695832100000018,3,2,5,5,Apr-15-2020,1,0.0,addition
1.0000143999999975,2,3,5,5,Apr-15-2020,1,98.99997119979264,addition
1.6396282000000042,9,2,11,11,Apr-15-2020,1,97.31161936576474,addition
1.1281862000000158,15,1,16,16,Apr-15-2020,1,98.72719589812952,addition
1.8395668,16,0,16,16,Apr-15-2020,1,96.61599398833776,addition
1.5122802999999865,8,8,16,16,Apr-15-2020,1,97.71300829423195,addition
2.015845200000001,10,19,29,29,Apr-15-2020,1,95.93636812963696,addition
1.6156384999999889,6,4,10,10,Apr-15-2020,1,97.38971223731778,addition
1.415096999999946,19,1,20,20,Apr-15-2020,1,97.99750048059116,addition
2.520229799999981,18,9,27,27,Apr-15-2020,1,93.64844175519205,addition
1.1277522999999974,5,4,9,9,Apr-15-2020,1,98.72817474984471,addition
3.4631074999999782,7,15,22,22,Apr-15-2020,1,88.0068864434439,addition
1.6485050999999658,11,11,22,22,Apr-15-2020,1,97.2824309352741,addition
1.4723336999999788,13,3,16,16,Apr-15-2020,1,97.83223347584438,addition
1.7881331000007776,3,18,21,21,Apr-16-2020,1,96.8025800166816,addition
1.0642813000004026,5,4,9,9,Apr-16-2020,1,98.86730531446945,addition
3.2318993999997474,9,8,17,17,Apr-16-2020,1,89.55482626828127,addition
2.375870300000315,8,7,15,15,Apr-16-2020,1,94.35524031757642,addition
1.3436169999995402,19,1,20,20,Apr-16-2020,1,98.19469335731223,addition
2.9841777999999977,17,14,31,31,Apr-16-2020,1,91.09468285798718,addition
2.622700099999747,19,5,24,24,Apr-16-2020,1,93.12144418546131,addition
1.1608175999999728,0,6,6,6,Apr-16-2020,1,98.6525024995303,addition
3.055315999999948,16,7,23,23,Apr-16-2020,1,90.66504414014432,addition
1.6960589999998774,10,13,23,23,Apr-16-2020,1,97.12338386851941,addition
2.040149399999791,9,13,22,22,Apr-16-2020,1,95.8377904256805,addition
2.391771799999333,9,12,21,21,Apr-16-2020,1,94.27942765672795,addition
3.3835003999993205,14,9,23,23,Apr-16-2020,1,88.55192504320443,addition
1.7360493999995017,7,3,10,10,Apr-16-2020,1,96.98613248076137,addition
1.2239855999996507,10,5,15,15,Apr-16-2020,1,98.50185925099349,addition
1.2235912000005555,11,1,12,12,Apr-16-2020,1,98.5028245752812,addition
1.576228699999774,3,14,17,17,Apr-16-2020,1,97.51550308529703,addition
3.3512206999994305,11,15,26,26,Apr-16-2020,1,88.76931981989533,addition
3.5034920000007332,12,15,27,27,Apr-16-2020,1,87.72554380593087,addition
1.911726000000272,7,17,24,24,Apr-16-2020,1,96.34530370092295,addition
1.1677796999993006,1,6,7,7,Apr-16-2020,1,98.63629057226954,addition
1.3680779999995138,2,15,17,17,Apr-16-2020,1,98.12836258591733,addition
1.4639545999998518,0,17,17,17,Apr-16-2020,1,97.85683692913928,addition
1.1759253999998691,9,9,18,18,Apr-16-2020,1,98.61719945363515,addition
1.423920199999884,5,15,20,20,Apr-16-2020,1,97.97245126403229,addition
1.2713170000006355,4,4,8,8,Apr-16-2020,1,98.38375308550938,addition
1.0875160000005053,0,15,15,15,Apr-16-2020,1,98.8173089497429,addition
1.5442948999998407,4,18,22,22,Apr-16-2020,1,97.61515326183448,addition
4.063782100000026,18,19,37,37,Apr-16-2020,1,83.48567504371938,addition
2.423768900000141,13,9,22,22,Apr-16-2020,1,94.12534431939211,addition
1.2721188000004986,9,2,11,11,Apr-16-2020,1,98.3817137586853,addition
1.143387399999483,1,14,15,15,Apr-16-2020,1,98.69266525352242,addition
1.519967500000348,2,13,15,15,Apr-16-2020,1,97.68969879894269,addition
1.4232007000000522,9,2,11,11,Apr-16-2020,1,97.97449976751936,addition
2.1598267999997915,7,5,12,12,Apr-16-2020,1,95.33514819400266,addition
1.9838727000005747,7,6,13,13,Apr-16-2020,1,96.06424911019243,addition
1.5118290999998862,1,13,14,14,Apr-16-2020,1,97.71437277239353,addition
1.2799733000001652,4,8,12,12,Apr-16-2020,1,98.36166835128668,addition
1.039549299999635,4,0,4,4,Apr-16-2020,1,98.91933725287026,addition
2.36022899999989,18,13,31,31,Apr-16-2020,1,94.42931906755952,addition
4.030962499999987,7,14,21,21,Apr-16-2020,1,83.75134132359386,addition
2.424128099999507,17,14,31,31,Apr-16-2020,1,94.12360295479279,addition
1.3442776000001686,7,7,14,14,Apr-16-2020,1,98.1929177341378,addition
3.9748927000000553,14,18,32,32,Apr-16-2020,1,84.20022802348628,addition
1.560048999999708,12,12,24,24,Apr-16-2020,1,97.56624711759991,addition
1.0643847999999707,5,4,9,9,Apr-16-2020,1,98.86708499752902,addition
2.2313502999995762,5,17,22,22,Apr-16-2020,1,95.0210758386918,addition
2.7916649999997394,11,15,26,26,Apr-16-2020,1,92.20660652777646,addition
1.2401755000000776,8,1,9,9,Apr-16-2020,1,98.46196472919955,addition
1.1760333000001992,1,5,6,6,Apr-16-2020,1,98.61694567729064,addition
1.0963768999999957,0,11,11,11,Apr-16-2020,1,98.7979576931464,addition
1.175341799999842,7,0,7,7,Apr-16-2020,1,98.61857165317313,addition
1.142749300000105,12,0,12,12,Apr-16-2020,1,98.69412403734927,addition
2.4081898000004003,14,6,20,20,Apr-16-2020,1,94.20062188717404,addition
4.431615800000143,16,18,34,34,Apr-16-2020,1,80.36078140118909,addition
1.3124237000001813,0,11,11,11,Apr-16-2020,1,98.27754403167783,addition
2.4550748000001477,1,3,4,4,Apr-16-2020,1,93.97260772640423,addition
0.9283026999992215,3,0,3,3,Apr-16-2020,1,99.13825409717415,addition
1.1278769000000466,0,12,12,12,Apr-16-2020,1,98.72789369844628,addition
1.5443566000003557,0,0,0,0,Apr-16-2020,1,97.61496269203533,addition
2.535143600000083,12,11,23,21,Apr-16-2020,0,42.15742234640757,addition
4.5917904000007175,11,9,20,20,Apr-16-2020,1,78.91546092246125,addition
1.199623700000302,4,4,8,8,Apr-16-2020,1,98.56090297839758,addition
1.2236384000007092,12,12,24,24,Apr-16-2020,1,98.5027090660437,addition
2.504079099999217,13,11,24,24,Apr-16-2020,1,93.7295878609471,addition
1.6557054999993852,11,10,21,21,Apr-16-2020,1,97.25863929727178,addition
1.9916743000003407,9,16,25,25,Apr-16-2020,1,96.03323348271815,addition
3.2642266000002564,16,18,34,34,Apr-16-2020,1,89.34482470385076,addition
3.2401632000000973,13,16,29,29,Apr-16-2020,1,89.50134243736512,addition
3.5432708000007547,6,16,22,22,Apr-16-2020,1,87.44523203786201,addition
2.4960737999999765,5,19,24,24,Apr-16-2020,1,93.76961558495368,addition
0.9520205999997416,0,6,6,6,Apr-16-2020,1,99.09365677717614,addition
2.0716173999999232,7,2,9,9,Apr-16-2020,1,95.70840134801756,addition
2.2074345999999423,9,7,16,16,Apr-16-2020,1,95.1272324867231,addition
1.0639608999999837,6,3,9,9,Apr-16-2020,1,98.86798720327123,addition
1.7034800999999788,8,16,24,24,Apr-16-2020,1,97.09815554890406,addition
0.7679241999994701,2,0,2,2,Apr-16-2020,1,99.41029242305517,addition
3.0720814000005703,19,15,34,34,Apr-16-2020,1,90.56231587177054,addition
4.9676274000003104,8,9,17,17,Apr-16-2020,1,75.32267801476615,addition
3.1917954999998983,14,19,33,33,Apr-16-2020,1,89.8124414861804,addition
2.616158699999687,13,18,31,31,Apr-16-2020,1,93.15571365641594,addition
1.5755190999998376,13,3,16,16,Apr-16-2020,1,97.5177395655357,addition
1.2880991000001814,1,13,14,14,Apr-16-2020,1,98.34080070857873,addition
0.8797617999998693,3,0,3,3,Apr-16-2020,1,99.22601917526099,addition
1.1350587000006271,7,2,9,9,Apr-16-2020,1,98.71164174755289,addition
1.3523144000000684,12,10,22,22,Apr-16-2020,1,98.17124576355245,addition
0.9843610999996601,1,2,3,3,Apr-16-2020,1,99.03103322480746,addition
1.199065800000426,0,11,11,11,Apr-16-2020,1,98.56224120726934,addition
1.08805620000021,6,4,10,10,Apr-16-2020,1,98.8161337056411,addition
1.3839323000001968,2,11,13,13,Apr-16-2020,1,98.08473138901617,addition
5.551526100000046,17,18,35,35,Apr-16-2020,1,69.18055796101828,addition
1.4724714000003587,15,15,30,30,Apr-16-2020,1,97.83182797618099,addition
1.1028886000003697,19,0,19,19,Apr-16-2020,1,98.78363673598922,addition
1.712147599999298,17,15,32,32,Apr-16-2020,1,97.06855059581665,addition
1.5041873000000123,3,16,19,19,Apr-16-2020,1,97.73742056651868,addition
1.5120092000006482,3,15,18,18,Apr-16-2020,1,97.7138281791134,addition
0.9987500999995972,0,12,12,12,Apr-16-2020,1,99.0024982377508,addition
2.312995199999932,15,8,23,23,Apr-16-2020,1,94.65005320477728,addition
1.127451100000144,2,6,8,8,Apr-16-2020,1,98.72885401710846,addition
1.0479862000001958,11,0,11,11,Apr-16-2020,1,98.90172492460916,addition
2.0791560999996364,15,14,29,29,Apr-16-2020,1,95.67710991183431,addition
1.3598670000000013,10,0,10,10,Apr-22-2020,1,98.15076174231099,addition
1.2714737999999954,6,4,10,10,Apr-22-2020,1,98.38335437591357,addition
1.6486182999999954,19,5,24,24,Apr-22-2020,1,97.28205770090513,addition
1.1593383000000017,0,19,19,19,Apr-22-2020,1,98.6559347061531,addition
6.6560387999999975,16,19,35,35,Apr-22-2020,1,55.697147492894594,addition
1.3273780999999971,1,1,2,2,Apr-22-2020,1,98.2380673796404,addition
6.631540100000002,13,19,32,32,Apr-22-2020,1,56.02267590209196,addition
1.4080644000000009,5,0,5,5,Apr-22-2020,1,98.01735464545264,addition
1.9681824999999973,19,9,28,28,Apr-22-2020,1,96.12625764669376,addition
1.9106155000000056,8,14,22,22,Apr-22-2020,1,96.34954841115973,addition
3.7832715999999915,15,19,34,34,Apr-22-2020,1,85.6868560006335,addition
2.224344700000003,6,11,17,17,Apr-22-2020,1,95.0522906555819,addition
2.1119491000000044,10,10,20,20,Apr-22-2020,1,95.53967099900918,addition
1.935175600000008,17,5,22,22,Apr-22-2020,1,96.25509539716461,addition
3.5277259000000067,8,17,25,25,Apr-22-2020,1,87.55514997446915,addition
2.6241930999999994,5,18,23,23,Apr-22-2020,1,93.1136105739124,addition
1.7275392999999897,7,8,15,15,Apr-22-2020,1,97.01560796695554,addition
1.82432,10,13,23,23,Apr-22-2020,1,96.67185653760001,addition
3.182713899999996,15,11,26,26,Apr-22-2020,1,89.87033223074681,addition
4.912023399999995,11,18,29,29,Apr-22-2020,1,75.87202611785249,addition
1.6322990000000033,19,19,38,38,Apr-22-2020,1,97.33559997459899,addition
1.8641468999999944,15,9,24,24,Apr-22-2020,1,96.52495633522041,addition
1.4551735999999948,18,1,19,19,Apr-22-2020,1,97.88246979386305,addition
1.0642579000000012,4,2,6,6,Apr-22-2020,1,98.86735512228759,addition
1.4472363,18,3,21,21,Apr-22-2020,1,97.9055070919623,addition
1.4872535000000084,6,14,20,20,Apr-22-2020,1,97.78807702673772,addition
1.6558149999999898,15,9,24,24,Apr-22-2020,1,97.25827668577503,addition
1.7599168999999932,6,3,9,9,Apr-22-2020,1,96.90269250509441,addition
1.0887041999999951,0,4,4,4,Apr-22-2020,1,98.81472316490238,addition
1.8543202999999977,13,4,17,17,Apr-22-2020,1,96.56149622500791,addition
2.9121233999999987,11,12,23,23,Apr-22-2020,1,91.51953730317244,addition
1.8869562,9,7,16,16,Apr-22-2020,1,96.43939629928155,addition
1.5763342000000051,7,13,20,20,Apr-22-2020,1,97.51517048991035,addition
3.2797040999999894,13,5,18,18,Apr-22-2020,1,89.24354101644326,addition
1.480079399999994,2,5,7,7,Apr-22-2020,1,97.80936496969566,addition
1.487197800000004,16,16,32,32,Apr-22-2020,1,97.78824270367515,addition
2.3677664000000083,2,13,15,15,Apr-22-2020,1,94.393682275031,addition
1.2641873999999973,1,18,19,19,Apr-22-2020,1,98.40183021768125,addition
1.6001571000000183,11,9,20,29,Apr-22-2020,0,0.0,addition
2.8802855000000136,11,17,28,28,Apr-22-2020,1,91.70395543848967,addition
2.6386162000000013,9,18,27,27,Apr-22-2020,1,93.03770454909755,addition
3.199905300000012,2,19,21,21,Apr-22-2020,1,89.76060607103183,addition
2.2881571000000065,7,6,13,13,Apr-22-2020,1,94.76433708571956,addition
1.3350880000000132,6,8,14,14,Apr-22-2020,1,98.21754003225597,addition
2.752018800000002,13,9,22,22,Apr-22-2020,1,92.42639252444656,addition
1.9205599999999947,8,14,22,22,Apr-22-2020,1,96.31144928640002,addition
1.1118546999999808,1,5,6,6,Apr-22-2020,1,98.76377912608795,addition
0.9350694999999972,0,1,1,1,Apr-22-2020,1,99.12564503016975,addition
1.3596933999999976,10,6,16,16,Apr-22-2020,1,98.15123385799644,addition
1.1039128000000176,2,1,3,3,Apr-22-2020,1,98.78137652999612,addition
2.4558226999999992,19,9,28,28,Apr-22-2020,1,93.96893486616472,addition
6.2801766999999975,11,15,26,26,Apr-22-2020,1,60.55938061677714,addition
3.0721848999999963,18,10,28,28,Apr-22-2020,1,90.56167994021202,addition
1.191195599999986,13,0,13,13,Apr-22-2020,1,98.58105304254067,addition
1.1118097000000091,10,10,20,20,Apr-22-2020,1,98.76387919098589,addition
2.3430759999999964,0,17,17,17,Apr-22-2020,1,94.50999485822402,addition
5.089106999999983,16,18,34,34,Apr-22-2020,1,74.10098994255117,addition
2.407367000000022,8,9,17,17,Apr-22-2020,1,94.2045841273109,addition
1.5508986999999763,1,10,11,11,Apr-22-2020,1,97.59471322233838,addition
1.6486295999999925,3,9,12,12,Apr-22-2020,1,97.28202044200387,addition
5.166837399999992,18,17,35,35,Apr-22-2020,1,73.30379128196132,addition
1.648316799999975,2,6,8,8,Apr-22-2020,1,97.28305172683784,addition
2.7667409999999957,13,18,31,31,Apr-22-2020,1,92.34514423891902,addition
2.1444874999999968,13,10,23,23,Apr-22-2020,1,95.40117336234377,addition
1.6478266000000021,8,10,18,18,Apr-22-2020,1,97.28466749633243,addition
2.736066999999992,15,13,28,28,Apr-22-2020,1,92.51393737151105,addition
2.0469015000000184,16,9,25,25,Apr-22-2020,1,95.81019424929768,addition
3.4490581999999956,10,4,14,14,Apr-22-2020,1,88.10399753301279,addition
1.5350430000000015,8,3,11,11,Apr-22-2020,1,97.643642988151,addition
3.0717903999999976,8,13,21,21,May-16-2020,1,90.56410373846785,addition
3.1110888000000045,9,6,15,15,May-16-2020,1,90.32112647851453,addition
2.256894599999999,17,9,26,26,Nov-02-2021,True,94.90642676449085,addition
2.2951657,7,18,25,25,Nov-02-2021,True,94.7322144095435,addition
2.8713967999999994,7,5,12,12,Nov-02-2021,True,91.75508041694977,addition
1.4468627000000005,15,0,15,15,Nov-02-2021,True,97.90658832734871,addition
1.2094918999999997,2,5,7,7,Nov-02-2021,True,98.5371293438344,addition
1.861478499999997,7,11,18,18,Nov-02-2021,True,96.53489779403776,addition
1.5816631,20,9,29,29,Nov-02-2021,True,97.49834183809838,addition
4.2323498000000015,6,13,19,19,Nov-02-2021,True,82.08721517043995,addition
1.434480500000003,11,4,15,15,Nov-02-2021,True,97.94226569511974,addition
2.5372506,16,12,28,28,Nov-02-2021,True,93.56235939279964,addition
1.5372234999999996,1,9,10,10,Nov-02-2021,True,97.63694391104775,addition
1.0954040000000003,0,0,0,0,Nov-02-2021,True,98.800090076784,addition
2.7010678000000006,20,11,31,31,Nov-02-2021,True,92.70423273980316,addition
2.3534369,12,16,28,28,Nov-02-2021,True,94.46133475771839,addition
